chain,create_count,factory_group_count,cumulative_factories,total_factories,cumulative_fraction
ethereum,1,78802,78802,120204,0.6555688662606901
ethereum,2,10071,88873,120204,0.7393514358923164
ethereum,3,4308,93181,120204,0.775190509467239
ethereum,4,4105,97286,120204,0.8093407873282087
ethereum,5,4465,101751,120204,0.8464859738444644
ethereum,6,3326,105077,120204,0.8741556021430236
ethereum,7,1058,106135,120204,0.8829573059132808
ethereum,8,928,107063,120204,0.8906775148913514
ethereum,9,629,107692,120204,0.8959102858473927
ethereum,10,1059,108751,120204,0.9047203088083591
ethereum,11,728,109479,120204,0.9107766796446042
ethereum,12,457,109936,120204,0.9145785497986756
ethereum,13,403,110339,120204,0.9179311836544541
ethereum,14,302,110641,120204,0.9204435792486106
ethereum,15,326,110967,120204,0.9231556354197864
ethereum,16,238,111205,120204,0.9251356028085588
ethereum,17,203,111408,120204,0.9268243985225117
ethereum,18,231,111639,120204,0.9287461315763202
ethereum,19,162,111801,120204,0.9300938404711989
ethereum,20,336,112137,120204,0.932889088549466
ethereum,21,168,112305,120204,0.9342867125885994
ethereum,22,141,112446,120204,0.9354597184785864
ethereum,23,115,112561,120204,0.9364164254101361
ethereum,24,121,112682,120204,0.9374230474859405
ethereum,25,137,112819,120204,0.9385627766130911
ethereum,26,115,112934,120204,0.9395194835446408
ethereum,27,79,113013,120204,0.9401766996106619
ethereum,28,108,113121,120204,0.9410751722072477
ethereum,29,88,113209,120204,0.941807260989651
ethereum,30,173,113382,120204,0.94324648098233
ethereum,31,87,113469,120204,0.9439702505740242
ethereum,32,430,113899,120204,0.9475475025789492
ethereum,33,81,113980,120204,0.9482213570263884
ethereum,34,75,114055,120204,0.948845296329573
ethereum,35,63,114118,120204,0.9493694053442481
ethereum,36,65,114183,120204,0.9499101527403414
ethereum,37,58,114241,120204,0.9503926658014709
ethereum,38,61,114302,120204,0.9509001364347276
ethereum,39,50,114352,120204,0.9513160959701841
ethereum,40,181,114533,120204,0.9528218694885362
ethereum,41,48,114581,120204,0.9532211906425743
ethereum,42,42,114623,120204,0.9535705966523577
ethereum,43,21,114644,120204,0.9537452996572493
ethereum,44,51,114695,120204,0.9541695783834149
ethereum,45,59,114754,120204,0.9546604106352534
ethereum,46,33,114787,120204,0.9549349439286546
ethereum,47,44,114831,120204,0.9553009883198562
ethereum,48,49,114880,120204,0.9557086286646035
ethereum,49,34,114914,120204,0.9559914811487139
ethereum,50,511,115425,120204,0.9602425876010782
ethereum,51,79,115504,120204,0.9608998036670993
ethereum,52,38,115542,120204,0.9612159329140462
ethereum,53,47,115589,120204,0.9616069348773751
ethereum,54,33,115622,120204,0.9618814681707764
ethereum,55,40,115662,120204,0.9622142357991414
ethereum,56,32,115694,120204,0.9624804499018336
ethereum,57,26,115720,120204,0.9626967488602709
ethereum,58,27,115747,120204,0.9629213670094173
ethereum,59,22,115769,120204,0.9631043892050182
ethereum,60,89,115858,120204,0.9638447971781305
ethereum,61,28,115886,120204,0.9640777345179861
ethereum,62,27,115913,120204,0.9643023526671325
ethereum,63,26,115939,120204,0.9645186516255698
ethereum,64,25,115964,120204,0.9647266313932981
ethereum,65,22,115986,120204,0.9649096535888989
ethereum,66,27,116013,120204,0.9651342717380453
ethereum,67,18,116031,120204,0.9652840171708096
ethereum,68,25,116056,120204,0.9654919969385378
ethereum,69,29,116085,120204,0.9657332534691025
ethereum,70,38,116123,120204,0.9660493827160493
ethereum,71,22,116145,120204,0.9662324049116502
ethereum,72,25,116170,120204,0.9664403846793784
ethereum,73,19,116189,120204,0.9665984493028518
ethereum,74,20,116209,120204,0.9667648331170344
ethereum,75,28,116237,120204,0.96699777045689
ethereum,76,19,116256,120204,0.9671558350803634
ethereum,77,23,116279,120204,0.9673471764666733
ethereum,78,13,116292,120204,0.967455325945892
ethereum,79,22,116314,120204,0.9676383481414927
ethereum,80,40,116354,120204,0.967971115769858
ethereum,81,17,116371,120204,0.9681125420119131
ethereum,82,21,116392,120204,0.9682872450168047
ethereum,83,11,116403,120204,0.9683787561146052
ethereum,84,20,116423,120204,0.9685451399287878
ethereum,85,7,116430,120204,0.9686033742637516
ethereum,86,12,116442,120204,0.9687032045522611
ethereum,87,14,116456,120204,0.968819673222189
ethereum,88,14,116470,120204,0.9689361418921167
ethereum,89,14,116484,120204,0.9690526105620445
ethereum,90,24,116508,120204,0.9692522711390635
ethereum,91,14,116522,120204,0.9693687398089914
ethereum,92,16,116538,120204,0.9695018468603375
ethereum,93,12,116550,120204,0.9696016771488469
ethereum,94,15,116565,120204,0.9697264650094839
ethereum,95,13,116578,120204,0.9698346144887026
ethereum,96,14,116592,120204,0.9699510831586303
ethereum,97,9,116601,120204,0.9700259558750125
ethereum,98,16,116617,120204,0.9701590629263586
ethereum,99,16,116633,120204,0.9702921699777046
ethereum,100,251,116884,120204,0.9723802868456957
ethereum,101,33,116917,120204,0.9726548201390969
ethereum,102,12,116929,120204,0.9727546504276064
ethereum,103,18,116947,120204,0.9729043958603707
ethereum,104,13,116960,120204,0.9730125453395894
ethereum,105,17,116977,120204,0.9731539715816445
ethereum,106,15,116992,120204,0.9732787594422815
ethereum,107,16,117008,120204,0.9734118664936275
ethereum,108,15,117023,120204,0.9735366543542644
ethereum,109,13,117036,120204,0.9736448038334831
ethereum,110,18,117054,120204,0.9737945492662474
ethereum,111,10,117064,120204,0.9738777411733387
ethereum,112,11,117075,120204,0.9739692522711391
ethereum,113,9,117084,120204,0.9740441249875212
ethereum,114,12,117096,120204,0.9741439552760307
ethereum,115,15,117111,120204,0.9742687431366677
ethereum,116,7,117118,120204,0.9743269774716316
ethereum,117,10,117128,120204,0.9744101693787228
ethereum,118,9,117137,120204,0.974485042095105
ethereum,119,6,117143,120204,0.9745349572393598
ethereum,120,21,117164,120204,0.9747096602442514
ethereum,121,10,117174,120204,0.9747928521513427
ethereum,122,9,117183,120204,0.9748677248677249
ethereum,123,11,117194,120204,0.9749592359655253
ethereum,124,8,117202,120204,0.9750257894911983
ethereum,125,7,117209,120204,0.9750840238261622
ethereum,126,14,117223,120204,0.97520049249609
ethereum,127,13,117236,120204,0.9753086419753086
ethereum,128,10,117246,120204,0.9753918338823999
ethereum,129,11,117257,120204,0.9754833449802003
ethereum,130,10,117267,120204,0.9755665368872916
ethereum,131,4,117271,120204,0.9755998136501282
ethereum,132,10,117281,120204,0.9756830055572194
ethereum,133,5,117286,120204,0.975724601510765
ethereum,134,9,117295,120204,0.9757994742271472
ethereum,135,14,117309,120204,0.975915942897075
ethereum,136,8,117317,120204,0.975982496422748
ethereum,137,3,117320,120204,0.9760074539948754
ethereum,138,7,117327,120204,0.9760656883298393
ethereum,139,4,117331,120204,0.9760989650926758
ethereum,140,12,117343,120204,0.9761987953811854
ethereum,141,5,117348,120204,0.976240391334731
ethereum,142,3,117351,120204,0.9762653489068583
ethereum,143,4,117355,120204,0.9762986256696948
ethereum,144,6,117361,120204,0.9763485408139496
ethereum,145,7,117368,120204,0.9764067751489135
ethereum,146,11,117379,120204,0.9764982862467139
ethereum,147,10,117389,120204,0.9765814781538052
ethereum,148,6,117395,120204,0.9766313932980599
ethereum,149,11,117406,120204,0.9767229043958604
ethereum,150,24,117430,120204,0.9769225649728794
ethereum,151,7,117437,120204,0.9769807993078433
ethereum,152,7,117444,120204,0.9770390336428072
ethereum,153,4,117448,120204,0.9770723104056437
ethereum,154,8,117456,120204,0.9771388639313168
ethereum,155,9,117465,120204,0.977213736647699
ethereum,156,7,117472,120204,0.9772719709826628
ethereum,157,7,117479,120204,0.9773302053176267
ethereum,158,7,117486,120204,0.9773884396525906
ethereum,159,8,117494,120204,0.9774549931782636
ethereum,160,14,117508,120204,0.9775714618481914
ethereum,161,3,117511,120204,0.9775964194203188
ethereum,162,7,117518,120204,0.9776546537552827
ethereum,163,3,117521,120204,0.9776796113274101
ethereum,164,3,117524,120204,0.9777045688995375
ethereum,165,5,117529,120204,0.9777461648530831
ethereum,166,6,117535,120204,0.9777960799973379
ethereum,167,6,117541,120204,0.9778459951415926
ethereum,168,4,117545,120204,0.9778792719044291
ethereum,169,3,117548,120204,0.9779042294765565
ethereum,170,7,117555,120204,0.9779624638115204
ethereum,171,2,117557,120204,0.9779791021929387
ethereum,172,6,117563,120204,0.9780290173371934
ethereum,173,3,117566,120204,0.9780539749093208
ethereum,174,10,117576,120204,0.978137166816412
ethereum,175,9,117585,120204,0.9782120395327942
ethereum,176,7,117592,120204,0.9782702738677581
ethereum,177,7,117599,120204,0.978328508202722
ethereum,178,8,117607,120204,0.9783950617283951
ethereum,179,7,117614,120204,0.978453296063359
ethereum,180,14,117628,120204,0.9785697647332867
ethereum,181,3,117631,120204,0.9785947223054141
ethereum,182,5,117636,120204,0.9786363182589598
ethereum,183,6,117642,120204,0.9786862334032146
ethereum,184,4,117646,120204,0.9787195101660511
ethereum,185,4,117650,120204,0.9787527869288876
ethereum,186,6,117656,120204,0.9788027020731423
ethereum,187,5,117661,120204,0.9788442980266879
ethereum,188,5,117666,120204,0.9788858939802336
ethereum,189,2,117668,120204,0.9789025323616518
ethereum,190,6,117674,120204,0.9789524475059066
ethereum,191,4,117678,120204,0.9789857242687431
ethereum,192,2,117680,120204,0.9790023626501614
ethereum,193,2,117682,120204,0.9790190010315797
ethereum,194,2,117684,120204,0.9790356394129979
ethereum,195,5,117689,120204,0.9790772353665436
ethereum,196,4,117693,120204,0.97911051212938
ethereum,197,4,117697,120204,0.9791437888922165
ethereum,198,3,117700,120204,0.9791687464643439
ethereum,199,7,117707,120204,0.9792269807993078
ethereum,200,74,117781,120204,0.9798426009117833
ethereum,201,18,117799,120204,0.9799923463445476
ethereum,202,4,117803,120204,0.9800256231073841
ethereum,203,4,117807,120204,0.9800588998702207
ethereum,204,3,117810,120204,0.980083857442348
ethereum,205,1,117811,120204,0.9800921766330571
ethereum,206,6,117817,120204,0.9801420917773119
ethereum,207,4,117821,120204,0.9801753685401484
ethereum,208,4,117825,120204,0.9802086453029849
ethereum,209,6,117831,120204,0.9802585604472397
ethereum,210,11,117842,120204,0.9803500715450401
ethereum,211,7,117849,120204,0.9804083058800039
ethereum,212,4,117853,120204,0.9804415826428405
ethereum,213,7,117860,120204,0.9804998169778044
ethereum,214,2,117862,120204,0.9805164553592226
ethereum,215,3,117865,120204,0.98054141293135
ethereum,216,2,117867,120204,0.9805580513127683
ethereum,217,4,117871,120204,0.9805913280756048
ethereum,218,3,117874,120204,0.9806162856477322
ethereum,219,5,117879,120204,0.9806578816012779
ethereum,220,11,117890,120204,0.9807493926990782
ethereum,221,5,117895,120204,0.9807909886526238
ethereum,222,5,117900,120204,0.9808325846061695
ethereum,223,3,117903,120204,0.9808575421782969
ethereum,224,7,117910,120204,0.9809157765132608
ethereum,225,5,117915,120204,0.9809573724668065
ethereum,226,5,117920,120204,0.9809989684203521
ethereum,227,5,117925,120204,0.9810405643738977
ethereum,228,3,117928,120204,0.9810655219460251
ethereum,229,4,117932,120204,0.9810987987088616
ethereum,230,2,117934,120204,0.9811154370902798
ethereum,231,3,117937,120204,0.9811403946624072
ethereum,232,4,117941,120204,0.9811736714252437
ethereum,233,5,117946,120204,0.9812152673787894
ethereum,234,1,117947,120204,0.9812235865694985
ethereum,235,8,117955,120204,0.9812901400951716
ethereum,236,3,117958,120204,0.981315097667299
ethereum,237,4,117962,120204,0.9813483744301355
ethereum,238,3,117965,120204,0.9813733320022628
ethereum,239,2,117967,120204,0.981389970383681
ethereum,240,6,117973,120204,0.9814398855279358
ethereum,241,1,117974,120204,0.981448204718645
ethereum,242,5,117979,120204,0.9814898006721906
ethereum,243,2,117981,120204,0.9815064390536089
ethereum,244,6,117987,120204,0.9815563541978636
ethereum,245,5,117992,120204,0.9815979501514093
ethereum,246,2,117994,120204,0.9816145885328276
ethereum,247,3,117997,120204,0.981639546104955
ethereum,248,3,118000,120204,0.9816645036770822
ethereum,249,3,118003,120204,0.9816894612492096
ethereum,250,15,118018,120204,0.9818142491098466
ethereum,251,4,118022,120204,0.9818475258726831
ethereum,252,4,118026,120204,0.9818808026355196
ethereum,253,1,118027,120204,0.9818891218262288
ethereum,254,5,118032,120204,0.9819307177797744
ethereum,255,2,118034,120204,0.9819473561611927
ethereum,256,4,118038,120204,0.9819806329240292
ethereum,257,4,118042,120204,0.9820139096868656
ethereum,258,2,118044,120204,0.9820305480682839
ethereum,259,6,118050,120204,0.9820804632125387
ethereum,260,7,118057,120204,0.9821386975475026
ethereum,261,1,118058,120204,0.9821470167382117
ethereum,262,1,118059,120204,0.9821553359289208
ethereum,263,4,118063,120204,0.9821886126917574
ethereum,264,2,118065,120204,0.9822052510731756
ethereum,265,6,118071,120204,0.9822551662174304
ethereum,266,2,118073,120204,0.9822718045988487
ethereum,267,3,118076,120204,0.9822967621709761
ethereum,268,1,118077,120204,0.9823050813616852
ethereum,269,1,118078,120204,0.9823134005523942
ethereum,270,6,118084,120204,0.982363315696649
ethereum,271,3,118087,120204,0.9823882732687764
ethereum,272,2,118089,120204,0.9824049116501947
ethereum,273,3,118092,120204,0.982429869222322
ethereum,274,2,118094,120204,0.9824465076037403
ethereum,275,4,118098,120204,0.9824797843665768
ethereum,276,5,118103,120204,0.9825213803201225
ethereum,277,2,118105,120204,0.9825380187015407
ethereum,278,3,118108,120204,0.9825629762736681
ethereum,279,5,118113,120204,0.9826045722272138
ethereum,280,6,118119,120204,0.9826544873714685
ethereum,281,2,118121,120204,0.9826711257528867
ethereum,282,5,118126,120204,0.9827127217064324
ethereum,284,4,118130,120204,0.9827459984692689
ethereum,285,2,118132,120204,0.9827626368506872
ethereum,286,5,118137,120204,0.9828042328042328
ethereum,288,2,118139,120204,0.9828208711856511
ethereum,289,3,118142,120204,0.9828458287577785
ethereum,290,3,118145,120204,0.9828707863299059
ethereum,291,4,118149,120204,0.9829040630927424
ethereum,292,4,118153,120204,0.9829373398555789
ethereum,293,2,118155,120204,0.9829539782369972
ethereum,294,3,118158,120204,0.9829789358091245
ethereum,295,4,118162,120204,0.983012212571961
ethereum,296,4,118166,120204,0.9830454893347975
ethereum,297,2,118168,120204,0.9830621277162158
ethereum,298,2,118170,120204,0.983078766097634
ethereum,299,1,118171,120204,0.9830870852883431
ethereum,300,23,118194,120204,0.983278426674653
ethereum,301,8,118202,120204,0.9833449802003261
ethereum,303,2,118204,120204,0.9833616185817444
ethereum,304,7,118211,120204,0.9834198529167083
ethereum,305,4,118215,120204,0.9834531296795448
ethereum,306,2,118217,120204,0.983469768060963
ethereum,307,1,118218,120204,0.9834780872516722
ethereum,308,4,118222,120204,0.9835113640145087
ethereum,309,1,118223,120204,0.9835196832052178
ethereum,310,7,118230,120204,0.9835779175401816
ethereum,311,3,118233,120204,0.983602875112309
ethereum,312,2,118235,120204,0.9836195134937273
ethereum,313,1,118236,120204,0.9836278326844364
ethereum,314,1,118237,120204,0.9836361518751456
ethereum,315,1,118238,120204,0.9836444710658547
ethereum,316,1,118239,120204,0.9836527902565638
ethereum,317,2,118241,120204,0.9836694286379821
ethereum,318,1,118242,120204,0.9836777478286912
ethereum,319,1,118243,120204,0.9836860670194003
ethereum,320,4,118247,120204,0.9837193437822369
ethereum,321,1,118248,120204,0.983727662972946
ethereum,324,2,118250,120204,0.9837443013543642
ethereum,325,2,118252,120204,0.9837609397357825
ethereum,326,5,118257,120204,0.9838025356893282
ethereum,328,2,118259,120204,0.9838191740707464
ethereum,329,3,118262,120204,0.9838441316428738
ethereum,330,1,118263,120204,0.9838524508335829
ethereum,331,6,118269,120204,0.9839023659778376
ethereum,332,2,118271,120204,0.9839190043592559
ethereum,333,2,118273,120204,0.9839356427406741
ethereum,334,1,118274,120204,0.9839439619313833
ethereum,335,3,118277,120204,0.9839689195035107
ethereum,336,6,118283,120204,0.9840188346477655
ethereum,337,1,118284,120204,0.9840271538384746
ethereum,339,1,118285,120204,0.9840354730291837
ethereum,340,2,118287,120204,0.984052111410602
ethereum,341,4,118291,120204,0.9840853881734385
ethereum,342,3,118294,120204,0.9841103457455659
ethereum,343,1,118295,120204,0.984118664936275
ethereum,344,3,118298,120204,0.9841436225084024
ethereum,346,5,118303,120204,0.9841852184619481
ethereum,347,2,118305,120204,0.9842018568433663
ethereum,349,2,118307,120204,0.9842184952247846
ethereum,350,10,118317,120204,0.9843016871318758
ethereum,351,5,118322,120204,0.9843432830854214
ethereum,352,3,118325,120204,0.9843682406575488
ethereum,353,6,118331,120204,0.9844181558018036
ethereum,354,2,118333,120204,0.9844347941832219
ethereum,355,2,118335,120204,0.9844514325646401
ethereum,356,1,118336,120204,0.9844597517553493
ethereum,357,4,118340,120204,0.9844930285181858
ethereum,359,3,118343,120204,0.9845179860903132
ethereum,360,4,118347,120204,0.9845512628531496
ethereum,361,1,118348,120204,0.9845595820438587
ethereum,363,3,118351,120204,0.9845845396159861
ethereum,365,3,118354,120204,0.9846094971881135
ethereum,366,1,118355,120204,0.9846178163788226
ethereum,367,2,118357,120204,0.9846344547602409
ethereum,368,1,118358,120204,0.98464277395095
ethereum,371,3,118361,120204,0.9846677315230774
ethereum,372,1,118362,120204,0.9846760507137866
ethereum,373,1,118363,120204,0.9846843699044957
ethereum,374,1,118364,120204,0.9846926890952048
ethereum,375,1,118365,120204,0.9847010082859139
ethereum,376,4,118369,120204,0.9847342850487505
ethereum,377,2,118371,120204,0.9847509234301687
ethereum,378,3,118374,120204,0.9847758810022961
ethereum,379,2,118376,120204,0.9847925193837144
ethereum,380,5,118381,120204,0.98483411533726
ethereum,382,3,118384,120204,0.9848590729093873
ethereum,383,1,118385,120204,0.9848673921000966
ethereum,384,3,118388,120204,0.9848923496722238
ethereum,385,3,118391,120204,0.9849173072443512
ethereum,386,2,118393,120204,0.9849339456257695
ethereum,387,1,118394,120204,0.9849422648164786
ethereum,388,2,118396,120204,0.9849589031978969
ethereum,389,1,118397,120204,0.984967222388606
ethereum,391,2,118399,120204,0.9849838607700243
ethereum,392,1,118400,120204,0.9849921799607334
ethereum,394,1,118401,120204,0.9850004991514425
ethereum,395,2,118403,120204,0.9850171375328608
ethereum,396,6,118409,120204,0.9850670526771156
ethereum,397,2,118411,120204,0.9850836910585338
ethereum,398,1,118412,120204,0.985092010249243
ethereum,399,3,118415,120204,0.9851169678213704
ethereum,400,16,118431,120204,0.9852500748727164
ethereum,401,5,118436,120204,0.985291670826262
ethereum,402,1,118437,120204,0.9852999900169711
ethereum,403,2,118439,120204,0.9853166283983894
ethereum,404,3,118442,120204,0.9853415859705168
ethereum,406,2,118444,120204,0.9853582243519351
ethereum,407,4,118448,120204,0.9853915011147716
ethereum,408,2,118450,120204,0.9854081394961898
ethereum,409,2,118452,120204,0.9854247778776081
ethereum,410,2,118454,120204,0.9854414162590264
ethereum,411,2,118456,120204,0.9854580546404446
ethereum,412,5,118461,120204,0.9854996505939903
ethereum,413,1,118462,120204,0.9855079697846993
ethereum,414,4,118466,120204,0.9855412465475358
ethereum,415,1,118467,120204,0.985549565738245
ethereum,416,3,118470,120204,0.9855745233103723
ethereum,417,1,118471,120204,0.9855828425010815
ethereum,419,1,118472,120204,0.9855911616917906
ethereum,420,3,118475,120204,0.985616119263918
ethereum,421,4,118479,120204,0.9856493960267545
ethereum,422,1,118480,120204,0.9856577152174636
ethereum,423,1,118481,120204,0.9856660344081728
ethereum,424,2,118483,120204,0.985682672789591
ethereum,425,3,118486,120204,0.9857076303617184
ethereum,426,2,118488,120204,0.9857242687431367
ethereum,429,1,118489,120204,0.9857325879338458
ethereum,431,1,118490,120204,0.985740907124555
ethereum,432,4,118494,120204,0.9857741838873915
ethereum,433,2,118496,120204,0.9857908222688097
ethereum,434,1,118497,120204,0.9857991414595189
ethereum,435,2,118499,120204,0.985815779840937
ethereum,437,1,118500,120204,0.9858240990316463
ethereum,438,2,118502,120204,0.9858407374130644
ethereum,440,3,118505,120204,0.9858656949851918
ethereum,441,3,118508,120204,0.9858906525573192
ethereum,445,1,118509,120204,0.9858989717480283
ethereum,447,2,118511,120204,0.9859156101294466
ethereum,448,3,118514,120204,0.985940567701574
ethereum,450,4,118518,120204,0.9859738444644105
ethereum,451,1,118519,120204,0.9859821636551196
ethereum,452,1,118520,120204,0.9859904828458288
ethereum,453,1,118521,120204,0.9859988020365379
ethereum,454,2,118523,120204,0.9860154404179562
ethereum,458,3,118526,120204,0.9860403979900835
ethereum,459,2,118528,120204,0.9860570363715018
ethereum,460,3,118531,120204,0.9860819939436292
ethereum,461,2,118533,120204,0.9860986323250475
ethereum,464,1,118534,120204,0.9861069515157566
ethereum,465,1,118535,120204,0.9861152707064657
ethereum,466,1,118536,120204,0.9861235898971749
ethereum,467,1,118537,120204,0.986131909087884
ethereum,468,1,118538,120204,0.986140228278593
ethereum,469,1,118539,120204,0.9861485474693021
ethereum,470,2,118541,120204,0.9861651858507204
ethereum,471,1,118542,120204,0.9861735050414295
ethereum,472,2,118544,120204,0.9861901434228478
ethereum,474,1,118545,120204,0.9861984626135569
ethereum,475,1,118546,120204,0.9862067818042661
ethereum,476,1,118547,120204,0.9862151009949752
ethereum,477,2,118549,120204,0.9862317393763934
ethereum,479,3,118552,120204,0.9862566969485208
ethereum,480,7,118559,120204,0.9863149312834848
ethereum,483,3,118562,120204,0.9863398888556121
ethereum,488,2,118564,120204,0.9863565272370304
ethereum,489,2,118566,120204,0.9863731656184487
ethereum,490,1,118567,120204,0.9863814848091578
ethereum,491,1,118568,120204,0.9863898039998669
ethereum,492,5,118573,120204,0.9864313999534126
ethereum,494,1,118574,120204,0.9864397191441217
ethereum,495,1,118575,120204,0.9864480383348307
ethereum,496,1,118576,120204,0.98645635752554
ethereum,497,1,118577,120204,0.986464676716249
ethereum,500,18,118595,120204,0.9866144221490133
ethereum,501,2,118597,120204,0.9866310605304316
ethereum,503,1,118598,120204,0.9866393797211407
ethereum,504,1,118599,120204,0.9866476989118499
ethereum,505,1,118600,120204,0.986656018102559
ethereum,510,1,118601,120204,0.9866643372932681
ethereum,514,2,118603,120204,0.9866809756746864
ethereum,516,3,118606,120204,0.9867059332468138
ethereum,517,2,118608,120204,0.986722571628232
ethereum,518,1,118609,120204,0.9867308908189412
ethereum,519,2,118611,120204,0.9867475292003594
ethereum,520,4,118615,120204,0.986780805963196
ethereum,521,1,118616,120204,0.986789125153905
ethereum,522,1,118617,120204,0.9867974443446141
ethereum,524,3,118620,120204,0.9868224019167415
ethereum,525,1,118621,120204,0.9868307211074506
ethereum,528,1,118622,120204,0.9868390402981598
ethereum,530,4,118626,120204,0.9868723170609963
ethereum,531,3,118629,120204,0.9868972746331237
ethereum,532,1,118630,120204,0.9869055938238328
ethereum,533,2,118632,120204,0.9869222322052511
ethereum,534,2,118634,120204,0.9869388705866693
ethereum,535,2,118636,120204,0.9869555089680876
ethereum,536,1,118637,120204,0.9869638281587967
ethereum,538,2,118639,120204,0.986980466540215
ethereum,540,6,118645,120204,0.9870303816844698
ethereum,541,3,118648,120204,0.9870553392565972
ethereum,542,2,118650,120204,0.9870719776380154
ethereum,544,2,118652,120204,0.9870886160194337
ethereum,546,2,118654,120204,0.9871052544008518
ethereum,547,2,118656,120204,0.9871218927822701
ethereum,548,1,118657,120204,0.9871302119729792
ethereum,549,1,118658,120204,0.9871385311636884
ethereum,550,6,118664,120204,0.9871884463079431
ethereum,551,2,118666,120204,0.9872050846893614
ethereum,552,2,118668,120204,0.9872217230707797
ethereum,553,1,118669,120204,0.9872300422614888
ethereum,554,1,118670,120204,0.9872383614521979
ethereum,555,1,118671,120204,0.9872466806429071
ethereum,556,1,118672,120204,0.9872549998336162
ethereum,557,1,118673,120204,0.9872633190243253
ethereum,558,1,118674,120204,0.9872716382150344
ethereum,559,2,118676,120204,0.9872882765964527
ethereum,561,1,118677,120204,0.9872965957871618
ethereum,562,1,118678,120204,0.987304914977871
ethereum,563,2,118680,120204,0.9873215533592892
ethereum,564,1,118681,120204,0.9873298725499984
ethereum,566,2,118683,120204,0.9873465109314166
ethereum,568,1,118684,120204,0.9873548301221258
ethereum,571,1,118685,120204,0.9873631493128349
ethereum,574,1,118686,120204,0.987371468503544
ethereum,579,1,118687,120204,0.987379787694253
ethereum,581,1,118688,120204,0.9873881068849623
ethereum,582,1,118689,120204,0.9873964260756714
ethereum,583,3,118692,120204,0.9874213836477987
ethereum,584,2,118694,120204,0.987438022029217
ethereum,586,1,118695,120204,0.9874463412199261
ethereum,587,2,118697,120204,0.9874629796013443
ethereum,588,2,118699,120204,0.9874796179827626
ethereum,590,1,118700,120204,0.9874879371734717
ethereum,592,1,118701,120204,0.9874962563641809
ethereum,594,1,118702,120204,0.98750457555489
ethereum,595,1,118703,120204,0.9875128947455991
ethereum,596,1,118704,120204,0.9875212139363083
ethereum,598,2,118706,120204,0.9875378523177265
ethereum,600,8,118714,120204,0.9876044058433996
ethereum,603,1,118715,120204,0.9876127250341087
ethereum,604,3,118718,120204,0.9876376826062361
ethereum,606,1,118719,120204,0.9876460017969452
ethereum,611,1,118720,120204,0.9876543209876543
ethereum,613,1,118721,120204,0.9876626401783635
ethereum,615,2,118723,120204,0.9876792785597817
ethereum,619,1,118724,120204,0.9876875977504909
ethereum,620,2,118726,120204,0.987704236131909
ethereum,621,2,118728,120204,0.9877208745133274
ethereum,625,1,118729,120204,0.9877291937040364
ethereum,626,3,118732,120204,0.9877541512761638
ethereum,628,2,118734,120204,0.9877707896575821
ethereum,630,3,118737,120204,0.9877957472297095
ethereum,633,3,118740,120204,0.9878207048018369
ethereum,637,3,118743,120204,0.9878456623739642
ethereum,638,1,118744,120204,0.9878539815646734
ethereum,640,3,118747,120204,0.9878789391368008
ethereum,644,2,118749,120204,0.987895577518219
ethereum,647,2,118751,120204,0.9879122158996373
ethereum,648,3,118754,120204,0.9879371734717647
ethereum,650,4,118758,120204,0.9879704502346012
ethereum,651,2,118760,120204,0.9879870886160195
ethereum,652,1,118761,120204,0.9879954078067286
ethereum,654,1,118762,120204,0.9880037269974377
ethereum,655,2,118764,120204,0.988020365378856
ethereum,658,2,118766,120204,0.9880370037602741
ethereum,659,3,118769,120204,0.9880619613324015
ethereum,660,2,118771,120204,0.9880785997138198
ethereum,661,1,118772,120204,0.9880869189045289
ethereum,664,1,118773,120204,0.9880952380952381
ethereum,670,1,118774,120204,0.9881035572859472
ethereum,673,1,118775,120204,0.9881118764766563
ethereum,674,2,118777,120204,0.9881285148580746
ethereum,675,1,118778,120204,0.9881368340487837
ethereum,676,1,118779,120204,0.9881451532394928
ethereum,678,1,118780,120204,0.988153472430202
ethereum,679,1,118781,120204,0.9881617916209111
ethereum,680,2,118783,120204,0.9881784300023294
ethereum,683,2,118785,120204,0.9881950683837476
ethereum,684,3,118788,120204,0.988220025955875
ethereum,687,1,118789,120204,0.9882283451465841
ethereum,688,1,118790,120204,0.9882366643372933
ethereum,689,1,118791,120204,0.9882449835280024
ethereum,690,1,118792,120204,0.9882533027187115
ethereum,693,2,118794,120204,0.9882699411001298
ethereum,697,4,118798,120204,0.9883032178629663
ethereum,698,3,118801,120204,0.9883281754350937
ethereum,699,1,118802,120204,0.9883364946258028
ethereum,700,6,118808,120204,0.9883864097700575
ethereum,701,3,118811,120204,0.9884113673421849
ethereum,702,1,118812,120204,0.988419686532894
ethereum,703,1,118813,120204,0.9884280057236032
ethereum,707,3,118816,120204,0.9884529632957306
ethereum,708,2,118818,120204,0.9884696016771488
ethereum,710,1,118819,120204,0.988477920867858
ethereum,711,1,118820,120204,0.9884862400585671
ethereum,712,1,118821,120204,0.9884945592492762
ethereum,719,4,118825,120204,0.9885278360121127
ethereum,720,1,118826,120204,0.9885361552028219
ethereum,721,1,118827,120204,0.988544474393531
ethereum,722,2,118829,120204,0.9885611127749493
ethereum,723,1,118830,120204,0.9885694319656584
ethereum,724,1,118831,120204,0.9885777511563675
ethereum,727,1,118832,120204,0.9885860703470767
ethereum,728,1,118833,120204,0.9885943895377858
ethereum,729,1,118834,120204,0.9886027087284949
ethereum,730,1,118835,120204,0.988611027919204
ethereum,731,1,118836,120204,0.9886193471099132
ethereum,735,2,118838,120204,0.9886359854913314
ethereum,736,1,118839,120204,0.9886443046820406
ethereum,741,1,118840,120204,0.9886526238727497
ethereum,743,1,118841,120204,0.9886609430634588
ethereum,744,1,118842,120204,0.988669262254168
ethereum,748,2,118844,120204,0.9886859006355861
ethereum,750,2,118846,120204,0.9887025390170044
ethereum,751,1,118847,120204,0.9887108582077135
ethereum,756,1,118848,120204,0.9887191773984226
ethereum,759,2,118850,120204,0.9887358157798409
ethereum,760,4,118854,120204,0.9887690925426774
ethereum,761,1,118855,120204,0.9887774117333866
ethereum,762,1,118856,120204,0.9887857309240957
ethereum,767,1,118857,120204,0.9887940501148048
ethereum,768,1,118858,120204,0.9888023693055139
ethereum,770,1,118859,120204,0.9888106884962231
ethereum,774,1,118860,120204,0.9888190076869322
ethereum,775,1,118861,120204,0.9888273268776413
ethereum,779,1,118862,120204,0.9888356460683505
ethereum,780,4,118866,120204,0.988868922831187
ethereum,781,1,118867,120204,0.9888772420218961
ethereum,783,1,118868,120204,0.9888855612126053
ethereum,784,2,118870,120204,0.9889021995940235
ethereum,787,1,118871,120204,0.9889105187847326
ethereum,789,2,118873,120204,0.9889271571661509
ethereum,792,1,118874,120204,0.98893547635686
ethereum,793,1,118875,120204,0.9889437955475692
ethereum,795,2,118877,120204,0.9889604339289874
ethereum,796,2,118879,120204,0.9889770723104057
ethereum,798,2,118881,120204,0.9889937106918238
ethereum,799,1,118882,120204,0.989002029882533
ethereum,800,3,118885,120204,0.9890269874546604
ethereum,801,3,118888,120204,0.9890519450267878
ethereum,802,1,118889,120204,0.9890602642174969
ethereum,815,1,118890,120204,0.989068583408206
ethereum,816,2,118892,120204,0.9890852217896243
ethereum,817,1,118893,120204,0.9890935409803334
ethereum,821,1,118894,120204,0.9891018601710425
ethereum,822,3,118897,120204,0.9891268177431699
ethereum,823,2,118899,120204,0.9891434561245882
ethereum,825,1,118900,120204,0.9891517753152973
ethereum,826,2,118902,120204,0.9891684136967156
ethereum,828,1,118903,120204,0.9891767328874247
ethereum,829,2,118905,120204,0.989193371268843
ethereum,832,1,118906,120204,0.9892016904595521
ethereum,836,1,118907,120204,0.9892100096502612
ethereum,838,1,118908,120204,0.9892183288409704
ethereum,840,3,118911,120204,0.9892432864130978
ethereum,842,2,118913,120204,0.989259924794516
ethereum,847,4,118917,120204,0.9892932015573525
ethereum,851,1,118918,120204,0.9893015207480617
ethereum,858,2,118920,120204,0.9893181591294798
ethereum,860,1,118921,120204,0.989326478320189
ethereum,862,2,118923,120204,0.9893431167016072
ethereum,867,3,118926,120204,0.9893680742737346
ethereum,868,1,118927,120204,0.9893763934644437
ethereum,870,1,118928,120204,0.9893847126551529
ethereum,871,1,118929,120204,0.989393031845862
ethereum,875,1,118930,120204,0.9894013510365711
ethereum,877,1,118931,120204,0.9894096702272803
ethereum,878,1,118932,120204,0.9894179894179894
ethereum,880,1,118933,120204,0.9894263086086985
ethereum,881,1,118934,120204,0.9894346277994077
ethereum,883,1,118935,120204,0.9894429469901168
ethereum,885,2,118937,120204,0.9894595853715351
ethereum,891,1,118938,120204,0.9894679045622442
ethereum,893,2,118940,120204,0.9894845429436624
ethereum,894,1,118941,120204,0.9894928621343716
ethereum,897,1,118942,120204,0.9895011813250807
ethereum,900,4,118946,120204,0.9895344580879172
ethereum,901,1,118947,120204,0.9895427772786264
ethereum,902,2,118949,120204,0.9895594156600446
ethereum,903,1,118950,120204,0.9895677348507537
ethereum,904,1,118951,120204,0.9895760540414629
ethereum,909,1,118952,120204,0.989584373232172
ethereum,910,2,118954,120204,0.9896010116135903
ethereum,911,1,118955,120204,0.9896093308042994
ethereum,915,1,118956,120204,0.9896176499950085
ethereum,920,1,118957,120204,0.9896259691857177
ethereum,921,1,118958,120204,0.9896342883764268
ethereum,923,2,118960,120204,0.989650926757845
ethereum,926,2,118962,120204,0.9896675651392632
ethereum,930,1,118963,120204,0.9896758843299723
ethereum,931,1,118964,120204,0.9896842035206815
ethereum,937,2,118966,120204,0.9897008419020997
ethereum,940,1,118967,120204,0.9897091610928089
ethereum,944,1,118968,120204,0.989717480283518
ethereum,947,1,118969,120204,0.9897257994742271
ethereum,948,3,118972,120204,0.9897507570463545
ethereum,955,1,118973,120204,0.9897590762370636
ethereum,957,1,118974,120204,0.9897673954277728
ethereum,960,1,118975,120204,0.9897757146184819
ethereum,962,2,118977,120204,0.9897923529999002
ethereum,964,1,118978,120204,0.9898006721906093
ethereum,965,1,118979,120204,0.9898089913813184
ethereum,966,2,118981,120204,0.9898256297627367
ethereum,968,4,118985,120204,0.9898589065255732
ethereum,973,1,118986,120204,0.9898672257162823
ethereum,976,1,118987,120204,0.9898755449069915
ethereum,978,2,118989,120204,0.9898921832884097
ethereum,980,1,118990,120204,0.9899005024791189
ethereum,982,1,118991,120204,0.989908821669828
ethereum,984,1,118992,120204,0.9899171408605371
ethereum,990,1,118993,120204,0.9899254600512463
ethereum,993,1,118994,120204,0.9899337792419554
ethereum,999,1,118995,120204,0.9899420984326645
ethereum,1000,11,119006,120204,0.9900336095304649
ethereum,1001,6,119012,120204,0.9900835246747196
ethereum,1004,1,119013,120204,0.9900918438654288
ethereum,1006,3,119016,120204,0.9901168014375562
ethereum,1007,1,119017,120204,0.9901251206282653
ethereum,1009,1,119018,120204,0.9901334398189744
ethereum,1011,2,119020,120204,0.9901500782003927
ethereum,1018,1,119021,120204,0.9901583973911018
ethereum,1019,1,119022,120204,0.9901667165818109
ethereum,1020,2,119024,120204,0.9901833549632292
ethereum,1021,1,119025,120204,0.9901916741539383
ethereum,1023,1,119026,120204,0.9901999933446475
ethereum,1024,2,119028,120204,0.9902166317260657
ethereum,1026,2,119030,120204,0.990233270107484
ethereum,1030,1,119031,120204,0.9902415892981931
ethereum,1034,1,119032,120204,0.9902499084889022
ethereum,1035,1,119033,120204,0.9902582276796114
ethereum,1037,1,119034,120204,0.9902665468703205
ethereum,1038,1,119035,120204,0.9902748660610295
ethereum,1043,1,119036,120204,0.9902831852517388
ethereum,1050,4,119040,120204,0.9903164620145752
ethereum,1051,1,119041,120204,0.9903247812052843
ethereum,1053,1,119042,120204,0.9903331003959934
ethereum,1056,1,119043,120204,0.9903414195867026
ethereum,1057,1,119044,120204,0.9903497387774117
ethereum,1059,2,119046,120204,0.99036637715883
ethereum,1060,2,119048,120204,0.9903830155402482
ethereum,1062,1,119049,120204,0.9903913347309574
ethereum,1066,1,119050,120204,0.9903996539216665
ethereum,1068,3,119053,120204,0.9904246114937939
ethereum,1071,2,119055,120204,0.9904412498752121
ethereum,1075,1,119056,120204,0.9904495690659213
ethereum,1076,1,119057,120204,0.9904578882566304
ethereum,1080,4,119061,120204,0.9904911650194669
ethereum,1089,1,119062,120204,0.9904994842101761
ethereum,1091,1,119063,120204,0.9905078034008852
ethereum,1096,1,119064,120204,0.9905161225915943
ethereum,1097,1,119065,120204,0.9905244417823034
ethereum,1098,1,119066,120204,0.9905327609730126
ethereum,1100,1,119067,120204,0.9905410801637217
ethereum,1104,1,119068,120204,0.9905493993544308
ethereum,1111,2,119070,120204,0.9905660377358491
ethereum,1120,1,119071,120204,0.9905743569265582
ethereum,1121,1,119072,120204,0.9905826761172674
ethereum,1123,2,119074,120204,0.9905993144986855
ethereum,1129,1,119075,120204,0.9906076336893948
ethereum,1130,1,119076,120204,0.9906159528801038
ethereum,1132,1,119077,120204,0.9906242720708129
ethereum,1134,1,119078,120204,0.990632591261522
ethereum,1136,2,119080,120204,0.9906492296429403
ethereum,1140,1,119081,120204,0.9906575488336494
ethereum,1147,1,119082,120204,0.9906658680243586
ethereum,1152,2,119084,120204,0.9906825064057768
ethereum,1153,1,119085,120204,0.990690825596486
ethereum,1155,2,119087,120204,0.9907074639779042
ethereum,1163,1,119088,120204,0.9907157831686133
ethereum,1164,2,119090,120204,0.9907324215500316
ethereum,1166,2,119092,120204,0.9907490599314499
ethereum,1168,1,119093,120204,0.990757379122159
ethereum,1175,1,119094,120204,0.9907656983128681
ethereum,1178,1,119095,120204,0.9907740175035773
ethereum,1179,2,119097,120204,0.9907906558849955
ethereum,1180,1,119098,120204,0.9907989750757047
ethereum,1181,1,119099,120204,0.9908072942664138
ethereum,1186,1,119100,120204,0.9908156134571229
ethereum,1193,1,119101,120204,0.990823932647832
ethereum,1198,3,119104,120204,0.9908488902199594
ethereum,1200,4,119108,120204,0.990882166982796
ethereum,1201,1,119109,120204,0.9908904861735051
ethereum,1205,1,119110,120204,0.9908988053642142
ethereum,1209,1,119111,120204,0.9909071245549232
ethereum,1217,1,119112,120204,0.9909154437456325
ethereum,1219,1,119113,120204,0.9909237629363415
ethereum,1220,1,119114,120204,0.9909320821270506
ethereum,1222,1,119115,120204,0.9909404013177598
ethereum,1228,1,119116,120204,0.9909487205084689
ethereum,1231,1,119117,120204,0.990957039699178
ethereum,1238,1,119118,120204,0.9909653588898872
ethereum,1246,1,119119,120204,0.9909736780805963
ethereum,1248,1,119120,120204,0.9909819972713054
ethereum,1251,2,119122,120204,0.9909986356527237
ethereum,1256,1,119123,120204,0.9910069548434328
ethereum,1258,2,119125,120204,0.9910235932248511
ethereum,1260,1,119126,120204,0.9910319124155602
ethereum,1267,1,119127,120204,0.9910402316062693
ethereum,1277,1,119128,120204,0.9910485507969785
ethereum,1279,1,119129,120204,0.9910568699876876
ethereum,1280,1,119130,120204,0.9910651891783967
ethereum,1284,2,119132,120204,0.991081827559815
ethereum,1300,2,119134,120204,0.9910984659412332
ethereum,1301,1,119135,120204,0.9911067851319424
ethereum,1302,1,119136,120204,0.9911151043226515
ethereum,1305,1,119137,120204,0.9911234235133606
ethereum,1310,1,119138,120204,0.9911317427040698
ethereum,1317,1,119139,120204,0.9911400618947789
ethereum,1318,1,119140,120204,0.991148381085488
ethereum,1321,1,119141,120204,0.9911567002761972
ethereum,1326,1,119142,120204,0.9911650194669063
ethereum,1330,2,119144,120204,0.9911816578483245
ethereum,1336,1,119145,120204,0.9911899770390337
ethereum,1343,1,119146,120204,0.9911982962297428
ethereum,1344,3,119149,120204,0.9912232538018702
ethereum,1348,1,119150,120204,0.9912315729925792
ethereum,1351,2,119152,120204,0.9912482113739975
ethereum,1352,1,119153,120204,0.9912565305647066
ethereum,1353,1,119154,120204,0.9912648497554158
ethereum,1359,2,119156,120204,0.991281488136834
ethereum,1360,2,119158,120204,0.9912981265182523
ethereum,1370,1,119159,120204,0.9913064457089614
ethereum,1371,1,119160,120204,0.9913147648996705
ethereum,1374,1,119161,120204,0.9913230840903797
ethereum,1380,2,119163,120204,0.9913397224717979
ethereum,1386,2,119165,120204,0.9913563608532162
ethereum,1389,1,119166,120204,0.9913646800439253
ethereum,1398,1,119167,120204,0.9913729992346344
ethereum,1400,2,119169,120204,0.9913896376160527
ethereum,1401,2,119171,120204,0.991406275997471
ethereum,1404,1,119172,120204,0.9914145951881801
ethereum,1410,1,119173,120204,0.9914229143788892
ethereum,1412,2,119175,120204,0.9914395527603075
ethereum,1413,1,119176,120204,0.9914478719510166
ethereum,1420,1,119177,120204,0.9914561911417258
ethereum,1428,2,119179,120204,0.991472829523144
ethereum,1430,1,119180,120204,0.9914811487138531
ethereum,1431,1,119181,120204,0.9914894679045623
ethereum,1432,1,119182,120204,0.9914977870952714
ethereum,1447,1,119183,120204,0.9915061062859805
ethereum,1450,1,119184,120204,0.9915144254766897
ethereum,1454,1,119185,120204,0.9915227446673988
ethereum,1456,2,119187,120204,0.9915393830488171
ethereum,1467,1,119188,120204,0.9915477022395262
ethereum,1468,1,119189,120204,0.9915560214302352
ethereum,1470,1,119190,120204,0.9915643406209443
ethereum,1476,1,119191,120204,0.9915726598116535
ethereum,1480,1,119192,120204,0.9915809790023626
ethereum,1485,1,119193,120204,0.9915892981930717
ethereum,1490,1,119194,120204,0.9915976173837809
ethereum,1491,2,119196,120204,0.9916142557651991
ethereum,1497,1,119197,120204,0.9916225749559083
ethereum,1500,2,119199,120204,0.9916392133373265
ethereum,1501,2,119201,120204,0.9916558517187448
ethereum,1505,1,119202,120204,0.9916641709094539
ethereum,1506,1,119203,120204,0.991672490100163
ethereum,1511,1,119204,120204,0.9916808092908722
ethereum,1512,1,119205,120204,0.9916891284815813
ethereum,1515,1,119206,120204,0.9916974476722904
ethereum,1518,1,119207,120204,0.9917057668629996
ethereum,1523,1,119208,120204,0.9917140860537087
ethereum,1524,1,119209,120204,0.9917224052444178
ethereum,1531,1,119210,120204,0.991730724435127
ethereum,1532,1,119211,120204,0.9917390436258361
ethereum,1536,1,119212,120204,0.9917473628165452
ethereum,1543,2,119214,120204,0.9917640011979635
ethereum,1546,1,119215,120204,0.9917723203886726
ethereum,1549,1,119216,120204,0.9917806395793817
ethereum,1559,1,119217,120204,0.9917889587700909
ethereum,1560,1,119218,120204,0.9917972779608
ethereum,1566,1,119219,120204,0.9918055971515091
ethereum,1568,2,119221,120204,0.9918222355329274
ethereum,1570,1,119222,120204,0.9918305547236365
ethereum,1571,2,119224,120204,0.9918471931050548
ethereum,1575,1,119225,120204,0.9918555122957639
ethereum,1578,3,119228,120204,0.9918804698678912
ethereum,1580,1,119229,120204,0.9918887890586003
ethereum,1585,1,119230,120204,0.9918971082493095
ethereum,1588,1,119231,120204,0.9919054274400186
ethereum,1593,1,119232,120204,0.9919137466307277
ethereum,1595,1,119233,120204,0.9919220658214369
ethereum,1596,2,119235,120204,0.9919387042028551
ethereum,1600,6,119241,120204,0.9919886193471099
ethereum,1606,1,119242,120204,0.991996938537819
ethereum,1619,1,119243,120204,0.9920052577285282
ethereum,1620,2,119245,120204,0.9920218961099464
ethereum,1622,1,119246,120204,0.9920302153006556
ethereum,1623,1,119247,120204,0.9920385344913647
ethereum,1625,1,119248,120204,0.9920468536820738
ethereum,1626,1,119249,120204,0.9920551728727829
ethereum,1627,1,119250,120204,0.9920634920634921
ethereum,1629,1,119251,120204,0.9920718112542012
ethereum,1634,2,119253,120204,0.9920884496356195
ethereum,1639,1,119254,120204,0.9920967688263286
ethereum,1640,2,119256,120204,0.9921134072077469
ethereum,1642,1,119257,120204,0.992121726398456
ethereum,1644,1,119258,120204,0.9921300455891651
ethereum,1645,1,119259,120204,0.9921383647798742
ethereum,1646,1,119260,120204,0.9921466839705834
ethereum,1652,1,119261,120204,0.9921550031612925
ethereum,1664,1,119262,120204,0.9921633223520016
ethereum,1672,1,119263,120204,0.9921716415427108
ethereum,1680,1,119264,120204,0.9921799607334199
ethereum,1681,1,119265,120204,0.992188279924129
ethereum,1686,1,119266,120204,0.9921965991148382
ethereum,1689,1,119267,120204,0.9922049183055472
ethereum,1690,1,119268,120204,0.9922132374962563
ethereum,1696,1,119269,120204,0.9922215566869655
ethereum,1697,1,119270,120204,0.9922298758776746
ethereum,1699,1,119271,120204,0.9922381950683837
ethereum,1700,1,119272,120204,0.9922465142590928
ethereum,1708,1,119273,120204,0.992254833449802
ethereum,1716,1,119274,120204,0.9922631526405111
ethereum,1720,1,119275,120204,0.9922714718312202
ethereum,1734,1,119276,120204,0.9922797910219294
ethereum,1742,1,119277,120204,0.9922881102126385
ethereum,1754,1,119278,120204,0.9922964294033476
ethereum,1756,1,119279,120204,0.9923047485940568
ethereum,1758,1,119280,120204,0.9923130677847659
ethereum,1759,1,119281,120204,0.992321386975475
ethereum,1761,1,119282,120204,0.9923297061661841
ethereum,1762,1,119283,120204,0.9923380253568933
ethereum,1768,1,119284,120204,0.9923463445476024
ethereum,1784,1,119285,120204,0.9923546637383115
ethereum,1790,1,119286,120204,0.9923629829290207
ethereum,1792,1,119287,120204,0.9923713021197298
ethereum,1798,1,119288,120204,0.9923796213104389
ethereum,1800,2,119290,120204,0.9923962596918572
ethereum,1801,1,119291,120204,0.9924045788825663
ethereum,1802,1,119292,120204,0.9924128980732755
ethereum,1804,1,119293,120204,0.9924212172639846
ethereum,1806,2,119295,120204,0.9924378556454028
ethereum,1810,1,119296,120204,0.992446174836112
ethereum,1821,1,119297,120204,0.9924544940268211
ethereum,1822,1,119298,120204,0.9924628132175302
ethereum,1823,1,119299,120204,0.9924711324082394
ethereum,1826,1,119300,120204,0.9924794515989485
ethereum,1830,1,119301,120204,0.9924877707896576
ethereum,1838,1,119302,120204,0.9924960899803668
ethereum,1839,1,119303,120204,0.9925044091710759
ethereum,1840,1,119304,120204,0.992512728361785
ethereum,1848,1,119305,120204,0.992521047552494
ethereum,1855,1,119306,120204,0.9925293667432032
ethereum,1857,1,119307,120204,0.9925376859339123
ethereum,1864,1,119308,120204,0.9925460051246214
ethereum,1876,1,119309,120204,0.9925543243153306
ethereum,1877,1,119310,120204,0.9925626435060397
ethereum,1882,1,119311,120204,0.9925709626967488
ethereum,1888,1,119312,120204,0.992579281887458
ethereum,1890,1,119313,120204,0.9925876010781671
ethereum,1892,1,119314,120204,0.9925959202688762
ethereum,1906,1,119315,120204,0.9926042394595854
ethereum,1917,1,119316,120204,0.9926125586502945
ethereum,1920,1,119317,120204,0.9926208778410036
ethereum,1932,1,119318,120204,0.9926291970317127
ethereum,1935,1,119319,120204,0.9926375162224219
ethereum,1945,1,119320,120204,0.992645835413131
ethereum,1946,1,119321,120204,0.9926541546038401
ethereum,1952,1,119322,120204,0.9926624737945493
ethereum,1959,1,119323,120204,0.9926707929852584
ethereum,1960,2,119325,120204,0.9926874313666767
ethereum,1971,1,119326,120204,0.9926957505573858
ethereum,1980,1,119327,120204,0.9927040697480949
ethereum,1983,1,119328,120204,0.992712388938804
ethereum,1988,1,119329,120204,0.9927207081295132
ethereum,1989,1,119330,120204,0.9927290273202223
ethereum,2000,2,119332,120204,0.9927456657016406
ethereum,2006,1,119333,120204,0.9927539848923497
ethereum,2008,1,119334,120204,0.9927623040830588
ethereum,2009,1,119335,120204,0.992770623273768
ethereum,2010,1,119336,120204,0.9927789424644771
ethereum,2016,1,119337,120204,0.9927872616551862
ethereum,2024,1,119338,120204,0.9927955808458954
ethereum,2029,1,119339,120204,0.9928039000366045
ethereum,2040,1,119340,120204,0.9928122192273136
ethereum,2048,1,119341,120204,0.9928205384180226
ethereum,2050,2,119343,120204,0.992837176799441
ethereum,2052,1,119344,120204,0.99284549599015
ethereum,2058,1,119345,120204,0.9928538151808592
ethereum,2070,1,119346,120204,0.9928621343715683
ethereum,2075,1,119347,120204,0.9928704535622774
ethereum,2080,1,119348,120204,0.9928787727529866
ethereum,2093,1,119349,120204,0.9928870919436957
ethereum,2100,2,119351,120204,0.9929037303251139
ethereum,2101,1,119352,120204,0.9929120495158231
ethereum,2113,1,119353,120204,0.9929203687065322
ethereum,2134,1,119354,120204,0.9929286878972413
ethereum,2142,1,119355,120204,0.9929370070879505
ethereum,2165,1,119356,120204,0.9929453262786596
ethereum,2171,1,119357,120204,0.9929536454693687
ethereum,2187,2,119359,120204,0.992970283850787
ethereum,2195,1,119360,120204,0.9929786030414961
ethereum,2197,2,119362,120204,0.9929952414229144
ethereum,2200,2,119364,120204,0.9930118798043326
ethereum,2201,2,119366,120204,0.9930285181857509
ethereum,2202,1,119367,120204,0.99303683737646
ethereum,2203,1,119368,120204,0.9930451565671692
ethereum,2204,1,119369,120204,0.9930534757578783
ethereum,2208,1,119370,120204,0.9930617949485874
ethereum,2209,1,119371,120204,0.9930701141392966
ethereum,2214,1,119372,120204,0.9930784333300057
ethereum,2223,2,119374,120204,0.9930950717114239
ethereum,2226,1,119375,120204,0.9931033909021331
ethereum,2230,1,119376,120204,0.9931117100928422
ethereum,2245,2,119378,120204,0.9931283484742605
ethereum,2250,1,119379,120204,0.9931366676649696
ethereum,2255,1,119380,120204,0.9931449868556786
ethereum,2258,1,119381,120204,0.9931533060463879
ethereum,2260,1,119382,120204,0.993161625237097
ethereum,2280,2,119384,120204,0.9931782636185152
ethereum,2290,1,119385,120204,0.9931865828092243
ethereum,2299,1,119386,120204,0.9931949019999334
ethereum,2300,1,119387,120204,0.9932032211906425
ethereum,2310,2,119389,120204,0.9932198595720608
ethereum,2316,1,119390,120204,0.9932281787627699
ethereum,2321,1,119391,120204,0.9932364979534791
ethereum,2329,1,119392,120204,0.9932448171441882
ethereum,2330,1,119393,120204,0.9932531363348973
ethereum,2338,2,119395,120204,0.9932697747163156
ethereum,2343,1,119396,120204,0.9932780939070247
ethereum,2346,1,119397,120204,0.9932864130977338
ethereum,2354,1,119398,120204,0.993294732288443
ethereum,2355,1,119399,120204,0.9933030514791521
ethereum,2356,1,119400,120204,0.9933113706698612
ethereum,2360,1,119401,120204,0.9933196898605704
ethereum,2370,1,119402,120204,0.9933280090512795
ethereum,2379,1,119403,120204,0.9933363282419886
ethereum,2395,1,119404,120204,0.9933446474326978
ethereum,2400,2,119406,120204,0.993361285814116
ethereum,2401,2,119408,120204,0.9933779241955343
ethereum,2411,1,119409,120204,0.9933862433862434
ethereum,2433,1,119410,120204,0.9933945625769525
ethereum,2440,2,119412,120204,0.9934112009583708
ethereum,2450,2,119414,120204,0.9934278393397891
ethereum,2453,1,119415,120204,0.9934361585304982
ethereum,2462,1,119416,120204,0.9934444777212073
ethereum,2473,1,119417,120204,0.9934527969119165
ethereum,2481,1,119418,120204,0.9934611161026256
ethereum,2492,1,119419,120204,0.9934694352933346
ethereum,2500,5,119424,120204,0.9935110312468803
ethereum,2501,2,119426,120204,0.9935276696282985
ethereum,2502,1,119427,120204,0.9935359888190077
ethereum,2512,1,119428,120204,0.9935443080097168
ethereum,2513,1,119429,120204,0.9935526272004259
ethereum,2538,1,119430,120204,0.9935609463911351
ethereum,2542,1,119431,120204,0.9935692655818442
ethereum,2552,1,119432,120204,0.9935775847725533
ethereum,2557,1,119433,120204,0.9935859039632624
ethereum,2566,1,119434,120204,0.9935942231539716
ethereum,2576,1,119435,120204,0.9936025423446807
ethereum,2578,2,119437,120204,0.993619180726099
ethereum,2581,2,119439,120204,0.9936358191075172
ethereum,2582,1,119440,120204,0.9936441382982264
ethereum,2585,1,119441,120204,0.9936524574889355
ethereum,2586,1,119442,120204,0.9936607766796446
ethereum,2592,1,119443,120204,0.9936690958703537
ethereum,2600,1,119444,120204,0.9936774150610629
ethereum,2606,1,119445,120204,0.993685734251772
ethereum,2614,1,119446,120204,0.9936940534424811
ethereum,2617,1,119447,120204,0.9937023726331903
ethereum,2630,1,119448,120204,0.9937106918238994
ethereum,2659,1,119449,120204,0.9937190110146085
ethereum,2672,1,119450,120204,0.9937273302053177
ethereum,2680,2,119452,120204,0.9937439685867359
ethereum,2705,1,119453,120204,0.9937522877774451
ethereum,2706,1,119454,120204,0.9937606069681542
ethereum,2729,1,119455,120204,0.9937689261588633
ethereum,2761,1,119456,120204,0.9937772453495723
ethereum,2800,1,119457,120204,0.9937855645402816
ethereum,2802,1,119458,120204,0.9937938837309906
ethereum,2814,1,119459,120204,0.9938022029216997
ethereum,2816,1,119460,120204,0.993810522112409
ethereum,2817,1,119461,120204,0.993818841303118
ethereum,2835,1,119462,120204,0.9938271604938271
ethereum,2840,2,119464,120204,0.9938437988752454
ethereum,2860,1,119465,120204,0.9938521180659545
ethereum,2891,1,119466,120204,0.9938604372566636
ethereum,2897,3,119469,120204,0.993885394828791
ethereum,2907,1,119470,120204,0.9938937140195002
ethereum,2914,1,119471,120204,0.9939020332102093
ethereum,2920,1,119472,120204,0.9939103524009184
ethereum,2948,1,119473,120204,0.9939186715916276
ethereum,2951,1,119474,120204,0.9939269907823367
ethereum,2952,1,119475,120204,0.9939353099730458
ethereum,2955,1,119476,120204,0.993943629163755
ethereum,2958,1,119477,120204,0.9939519483544641
ethereum,2959,1,119478,120204,0.9939602675451732
ethereum,2971,1,119479,120204,0.9939685867358823
ethereum,2986,1,119480,120204,0.9939769059265915
ethereum,2987,1,119481,120204,0.9939852251173006
ethereum,2990,1,119482,120204,0.9939935443080097
ethereum,3000,4,119486,120204,0.9940268210708463
ethereum,3001,1,119487,120204,0.9940351402615554
ethereum,3002,1,119488,120204,0.9940434594522645
ethereum,3004,1,119489,120204,0.9940517786429736
ethereum,3007,1,119490,120204,0.9940600978336828
ethereum,3020,1,119491,120204,0.9940684170243919
ethereum,3025,1,119492,120204,0.994076736215101
ethereum,3040,2,119494,120204,0.9940933745965193
ethereum,3043,1,119495,120204,0.9941016937872283
ethereum,3049,1,119496,120204,0.9941100129779376
ethereum,3056,1,119497,120204,0.9941183321686466
ethereum,3060,1,119498,120204,0.9941266513593557
ethereum,3063,1,119499,120204,0.994134970550065
ethereum,3082,1,119500,120204,0.994143289740774
ethereum,3090,1,119501,120204,0.9941516089314831
ethereum,3130,1,119502,120204,0.9941599281221922
ethereum,3133,1,119503,120204,0.9941682473129014
ethereum,3176,1,119504,120204,0.9941765665036105
ethereum,3183,1,119505,120204,0.9941848856943196
ethereum,3189,1,119506,120204,0.9941932048850288
ethereum,3190,1,119507,120204,0.9942015240757379
ethereum,3192,1,119508,120204,0.994209843266447
ethereum,3200,2,119510,120204,0.9942264816478653
ethereum,3207,1,119511,120204,0.9942348008385744
ethereum,3220,2,119513,120204,0.9942514392199927
ethereum,3234,1,119514,120204,0.9942597584107018
ethereum,3251,1,119515,120204,0.9942680776014109
ethereum,3254,2,119517,120204,0.9942847159828292
ethereum,3260,1,119518,120204,0.9942930351735383
ethereum,3266,1,119519,120204,0.9943013543642475
ethereum,3270,1,119520,120204,0.9943096735549566
ethereum,3276,1,119521,120204,0.9943179927456657
ethereum,3280,1,119522,120204,0.9943263119363749
ethereum,3294,1,119523,120204,0.994334631127084
ethereum,3300,2,119525,120204,0.9943512695085022
ethereum,3310,1,119526,120204,0.9943595886992114
ethereum,3322,1,119527,120204,0.9943679078899205
ethereum,3326,1,119528,120204,0.9943762270806296
ethereum,3330,2,119530,120204,0.9943928654620479
ethereum,3333,1,119531,120204,0.994401184652757
ethereum,3335,1,119532,120204,0.9944095038434662
ethereum,3336,1,119533,120204,0.9944178230341753
ethereum,3351,1,119534,120204,0.9944261422248843
ethereum,3354,1,119535,120204,0.9944344614155934
ethereum,3393,1,119536,120204,0.9944427806063026
ethereum,3400,2,119538,120204,0.9944594189877208
ethereum,3401,1,119539,120204,0.99446773817843
ethereum,3406,1,119540,120204,0.9944760573691391
ethereum,3435,1,119541,120204,0.9944843765598482
ethereum,3448,1,119542,120204,0.9944926957505574
ethereum,3450,1,119543,120204,0.9945010149412665
ethereum,3452,1,119544,120204,0.9945093341319756
ethereum,3455,1,119545,120204,0.9945176533226847
ethereum,3466,1,119546,120204,0.9945259725133939
ethereum,3478,1,119547,120204,0.994534291704103
ethereum,3480,1,119548,120204,0.9945426108948121
ethereum,3486,1,119549,120204,0.9945509300855213
ethereum,3526,1,119550,120204,0.9945592492762304
ethereum,3548,1,119551,120204,0.9945675684669395
ethereum,3554,1,119552,120204,0.9945758876576487
ethereum,3560,1,119553,120204,0.9945842068483578
ethereum,3590,1,119554,120204,0.9945925260390669
ethereum,3595,1,119555,120204,0.9946008452297761
ethereum,3600,2,119557,120204,0.9946174836111943
ethereum,3608,1,119558,120204,0.9946258028019034
ethereum,3615,1,119559,120204,0.9946341219926126
ethereum,3633,1,119560,120204,0.9946424411833217
ethereum,3641,1,119561,120204,0.9946507603740308
ethereum,3650,2,119563,120204,0.9946673987554491
ethereum,3654,1,119564,120204,0.9946757179461582
ethereum,3658,1,119565,120204,0.9946840371368674
ethereum,3663,1,119566,120204,0.9946923563275765
ethereum,3679,1,119567,120204,0.9947006755182856
ethereum,3680,1,119568,120204,0.9947089947089947
ethereum,3682,1,119569,120204,0.9947173138997039
ethereum,3690,1,119570,120204,0.994725633090413
ethereum,3694,1,119571,120204,0.994733952281122
ethereum,3695,1,119572,120204,0.9947422714718313
ethereum,3702,2,119574,120204,0.9947589098532494
ethereum,3705,1,119575,120204,0.9947672290439586
ethereum,3713,1,119576,120204,0.9947755482346677
ethereum,3720,1,119577,120204,0.9947838674253768
ethereum,3730,1,119578,120204,0.994792186616086
ethereum,3755,1,119579,120204,0.9948005058067951
ethereum,3772,1,119580,120204,0.9948088249975042
ethereum,3783,1,119581,120204,0.9948171441882133
ethereum,3790,1,119582,120204,0.9948254633789225
ethereum,3797,1,119583,120204,0.9948337825696316
ethereum,3800,1,119584,120204,0.9948421017603407
ethereum,3802,1,119585,120204,0.9948504209510499
ethereum,3819,1,119586,120204,0.994858740141759
ethereum,3826,1,119587,120204,0.9948670593324681
ethereum,3827,1,119588,120204,0.9948753785231773
ethereum,3845,1,119589,120204,0.9948836977138864
ethereum,3870,1,119590,120204,0.9948920169045955
ethereum,3874,1,119591,120204,0.9949003360953046
ethereum,3884,1,119592,120204,0.9949086552860138
ethereum,3899,1,119593,120204,0.9949169744767229
ethereum,3900,1,119594,120204,0.994925293667432
ethereum,3902,1,119595,120204,0.9949336128581412
ethereum,3910,2,119597,120204,0.9949502512395594
ethereum,3936,1,119598,120204,0.9949585704302686
ethereum,3946,1,119599,120204,0.9949668896209777
ethereum,3960,1,119600,120204,0.9949752088116868
ethereum,4000,1,119601,120204,0.994983528002396
ethereum,4018,1,119602,120204,0.9949918471931051
ethereum,4037,1,119603,120204,0.9950001663838142
ethereum,4059,1,119604,120204,0.9950084855745233
ethereum,4060,1,119605,120204,0.9950168047652325
ethereum,4068,1,119606,120204,0.9950251239559416
ethereum,4080,1,119607,120204,0.9950334431466507
ethereum,4090,1,119608,120204,0.9950417623373599
ethereum,4100,1,119609,120204,0.995050081528069
ethereum,4116,1,119610,120204,0.995058400718778
ethereum,4122,1,119611,120204,0.9950667199094873
ethereum,4129,1,119612,120204,0.9950750391001963
ethereum,4132,1,119613,120204,0.9950833582909054
ethereum,4149,1,119614,120204,0.9950916774816145
ethereum,4205,1,119615,120204,0.9950999966723237
ethereum,4232,1,119616,120204,0.9951083158630328
ethereum,4240,1,119617,120204,0.9951166350537419
ethereum,4242,1,119618,120204,0.9951249542444511
ethereum,4250,1,119619,120204,0.9951332734351602
ethereum,4252,1,119620,120204,0.9951415926258693
ethereum,4253,1,119621,120204,0.9951499118165785
ethereum,4258,1,119622,120204,0.9951582310072876
ethereum,4284,1,119623,120204,0.9951665501979967
ethereum,4288,1,119624,120204,0.9951748693887059
ethereum,4304,2,119626,120204,0.9951915077701241
ethereum,4312,1,119627,120204,0.9951998269608332
ethereum,4351,1,119628,120204,0.9952081461515424
ethereum,4369,1,119629,120204,0.9952164653422515
ethereum,4370,1,119630,120204,0.9952247845329606
ethereum,4383,1,119631,120204,0.9952331037236698
ethereum,4390,1,119632,120204,0.9952414229143789
ethereum,4400,2,119634,120204,0.9952580612957972
ethereum,4414,1,119635,120204,0.9952663804865063
ethereum,4424,1,119636,120204,0.9952746996772154
ethereum,4425,1,119637,120204,0.9952830188679245
ethereum,4428,1,119638,120204,0.9952913380586337
ethereum,4459,1,119639,120204,0.9952996572493428
ethereum,4487,1,119640,120204,0.9953079764400519
ethereum,4491,1,119641,120204,0.9953162956307611
ethereum,4492,1,119642,120204,0.9953246148214702
ethereum,4500,2,119644,120204,0.9953412532028885
ethereum,4570,1,119645,120204,0.9953495723935976
ethereum,4605,1,119646,120204,0.9953578915843067
ethereum,4615,1,119647,120204,0.9953662107750159
ethereum,4616,1,119648,120204,0.995374529965725
ethereum,4629,1,119649,120204,0.995382849156434
ethereum,4643,1,119650,120204,0.9953911683471431
ethereum,4645,1,119651,120204,0.9953994875378523
ethereum,4649,1,119652,120204,0.9954078067285614
ethereum,4651,1,119653,120204,0.9954161259192705
ethereum,4679,1,119654,120204,0.9954244451099797
ethereum,4683,1,119655,120204,0.9954327643006888
ethereum,4702,1,119656,120204,0.9954410834913979
ethereum,4717,1,119657,120204,0.9954494026821071
ethereum,4721,1,119658,120204,0.9954577218728162
ethereum,4740,1,119659,120204,0.9954660410635253
ethereum,4750,1,119660,120204,0.9954743602542344
ethereum,4760,1,119661,120204,0.9954826794449436
ethereum,4776,1,119662,120204,0.9954909986356527
ethereum,4823,1,119663,120204,0.9954993178263618
ethereum,4847,1,119664,120204,0.995507637017071
ethereum,4880,1,119665,120204,0.9955159562077801
ethereum,4908,1,119666,120204,0.9955242753984892
ethereum,4920,1,119667,120204,0.9955325945891984
ethereum,4960,1,119668,120204,0.9955409137799075
ethereum,4969,1,119669,120204,0.9955492329706166
ethereum,4983,1,119670,120204,0.9955575521613258
ethereum,5000,4,119674,120204,0.9955908289241623
ethereum,5002,1,119675,120204,0.9955991481148714
ethereum,5025,1,119676,120204,0.9956074673055805
ethereum,5041,1,119677,120204,0.9956157864962897
ethereum,5061,1,119678,120204,0.9956241056869988
ethereum,5090,1,119679,120204,0.9956324248777079
ethereum,5092,1,119680,120204,0.9956407440684171
ethereum,5094,1,119681,120204,0.9956490632591262
ethereum,5096,1,119682,120204,0.9956573824498353
ethereum,5102,1,119683,120204,0.9956657016405444
ethereum,5118,1,119684,120204,0.9956740208312536
ethereum,5131,1,119685,120204,0.9956823400219627
ethereum,5160,1,119686,120204,0.9956906592126717
ethereum,5167,1,119687,120204,0.995698978403381
ethereum,5209,1,119688,120204,0.99570729759409
ethereum,5211,1,119689,120204,0.9957156167847991
ethereum,5226,1,119690,120204,0.9957239359755083
ethereum,5229,1,119691,120204,0.9957322551662174
ethereum,5250,1,119692,120204,0.9957405743569265
ethereum,5279,1,119693,120204,0.9957488935476357
ethereum,5280,1,119694,120204,0.9957572127383448
ethereum,5294,1,119695,120204,0.9957655319290539
ethereum,5310,1,119696,120204,0.995773851119763
ethereum,5326,1,119697,120204,0.9957821703104722
ethereum,5408,1,119698,120204,0.9957904895011813
ethereum,5456,1,119699,120204,0.9957988086918904
ethereum,5475,1,119700,120204,0.9958071278825996
ethereum,5481,1,119701,120204,0.9958154470733087
ethereum,5491,1,119702,120204,0.9958237662640178
ethereum,5498,1,119703,120204,0.995832085454727
ethereum,5513,1,119704,120204,0.9958404046454361
ethereum,5552,1,119705,120204,0.9958487238361452
ethereum,5555,1,119706,120204,0.9958570430268543
ethereum,5561,1,119707,120204,0.9958653622175635
ethereum,5573,1,119708,120204,0.9958736814082726
ethereum,5670,1,119709,120204,0.9958820005989817
ethereum,5671,2,119711,120204,0.9958986389804
ethereum,5680,1,119712,120204,0.9959069581711091
ethereum,5720,1,119713,120204,0.9959152773618183
ethereum,5778,1,119714,120204,0.9959235965525274
ethereum,5787,1,119715,120204,0.9959319157432365
ethereum,5824,1,119716,120204,0.9959402349339457
ethereum,5920,1,119717,120204,0.9959485541246548
ethereum,5973,1,119718,120204,0.9959568733153639
ethereum,6002,1,119719,120204,0.995965192506073
ethereum,6004,1,119720,120204,0.9959735116967822
ethereum,6006,1,119721,120204,0.9959818308874913
ethereum,6036,1,119722,120204,0.9959901500782004
ethereum,6048,1,119723,120204,0.9959984692689096
ethereum,6049,1,119724,120204,0.9960067884596187
ethereum,6080,1,119725,120204,0.9960151076503277
ethereum,6118,1,119726,120204,0.996023426841037
ethereum,6120,1,119727,120204,0.996031746031746
ethereum,6127,1,119728,120204,0.9960400652224551
ethereum,6143,1,119729,120204,0.9960483844131642
ethereum,6149,1,119730,120204,0.9960567036038734
ethereum,6150,1,119731,120204,0.9960650227945825
ethereum,6200,1,119732,120204,0.9960733419852916
ethereum,6216,1,119733,120204,0.9960816611760008
ethereum,6258,1,119734,120204,0.9960899803667099
ethereum,6280,1,119735,120204,0.996098299557419
ethereum,6300,2,119737,120204,0.9961149379388373
ethereum,6373,1,119738,120204,0.9961232571295464
ethereum,6396,1,119739,120204,0.9961315763202556
ethereum,6400,2,119741,120204,0.9961482147016738
ethereum,6432,1,119742,120204,0.9961565338923829
ethereum,6441,1,119743,120204,0.9961648530830921
ethereum,6445,1,119744,120204,0.9961731722738012
ethereum,6601,1,119745,120204,0.9961814914645103
ethereum,6635,1,119746,120204,0.9961898106552195
ethereum,6662,1,119747,120204,0.9961981298459286
ethereum,6667,1,119748,120204,0.9962064490366377
ethereum,6678,1,119749,120204,0.9962147682273469
ethereum,6699,1,119750,120204,0.996223087418056
ethereum,6731,1,119751,120204,0.9962314066087651
ethereum,6760,2,119753,120204,0.9962480449901834
ethereum,6773,1,119754,120204,0.9962563641808925
ethereum,6844,1,119755,120204,0.9962646833716016
ethereum,6850,2,119757,120204,0.9962813217530199
ethereum,6853,1,119758,120204,0.996289640943729
ethereum,6888,1,119759,120204,0.9962979601344382
ethereum,6943,1,119760,120204,0.9963062793251473
ethereum,6944,1,119761,120204,0.9963145985158564
ethereum,6969,1,119762,120204,0.9963229177065656
ethereum,7090,1,119763,120204,0.9963312368972747
ethereum,7098,1,119764,120204,0.9963395560879837
ethereum,7103,1,119765,120204,0.9963478752786928
ethereum,7140,1,119766,120204,0.996356194469402
ethereum,7141,1,119767,120204,0.9963645136601111
ethereum,7147,1,119768,120204,0.9963728328508202
ethereum,7160,1,119769,120204,0.9963811520415294
ethereum,7201,1,119770,120204,0.9963894712322385
ethereum,7211,1,119771,120204,0.9963977904229476
ethereum,7214,1,119772,120204,0.9964061096136568
ethereum,7273,1,119773,120204,0.9964144288043659
ethereum,7299,1,119774,120204,0.996422747995075
ethereum,7300,1,119775,120204,0.9964310671857841
ethereum,7311,1,119776,120204,0.9964393863764933
ethereum,7321,1,119777,120204,0.9964477055672024
ethereum,7424,1,119778,120204,0.9964560247579115
ethereum,7443,1,119779,120204,0.9964643439486207
ethereum,7473,1,119780,120204,0.9964726631393298
ethereum,7480,1,119781,120204,0.9964809823300389
ethereum,7505,1,119782,120204,0.9964893015207481
ethereum,7518,1,119783,120204,0.9964976207114572
ethereum,7522,1,119784,120204,0.9965059399021663
ethereum,7542,1,119785,120204,0.9965142590928755
ethereum,7564,2,119787,120204,0.9965308974742937
ethereum,7585,1,119788,120204,0.9965392166650028
ethereum,7602,1,119789,120204,0.996547535855712
ethereum,7641,1,119790,120204,0.9965558550464211
ethereum,7663,1,119791,120204,0.9965641742371302
ethereum,7734,1,119792,120204,0.9965724934278394
ethereum,7749,1,119793,120204,0.9965808126185485
ethereum,7773,1,119794,120204,0.9965891318092576
ethereum,7800,1,119795,120204,0.9965974509999668
ethereum,7830,1,119796,120204,0.9966057701906759
ethereum,7905,1,119797,120204,0.996614089381385
ethereum,7932,1,119798,120204,0.996622408572094
ethereum,8077,1,119799,120204,0.9966307277628033
ethereum,8103,1,119800,120204,0.9966390469535124
ethereum,8190,1,119801,120204,0.9966473661442214
ethereum,8224,1,119802,120204,0.9966556853349307
ethereum,8253,1,119803,120204,0.9966640045256397
ethereum,8381,1,119804,120204,0.9966723237163488
ethereum,8382,1,119805,120204,0.996680642907058
ethereum,8400,1,119806,120204,0.9966889620977671
ethereum,8406,1,119807,120204,0.9966972812884762
ethereum,8476,2,119809,120204,0.9967139196698945
ethereum,8501,1,119810,120204,0.9967222388606036
ethereum,8534,1,119811,120204,0.9967305580513127
ethereum,8541,1,119812,120204,0.9967388772420219
ethereum,8567,1,119813,120204,0.996747196432731
ethereum,8600,1,119814,120204,0.9967555156234401
ethereum,8628,1,119815,120204,0.9967638348141493
ethereum,8658,1,119816,120204,0.9967721540048584
ethereum,8700,1,119817,120204,0.9967804731955675
ethereum,8702,1,119818,120204,0.9967887923862767
ethereum,8705,1,119819,120204,0.9967971115769858
ethereum,8732,1,119820,120204,0.9968054307676949
ethereum,8800,1,119821,120204,0.996813749958404
ethereum,8809,1,119822,120204,0.9968220691491132
ethereum,8896,1,119823,120204,0.9968303883398223
ethereum,8920,1,119824,120204,0.9968387075305314
ethereum,8924,1,119825,120204,0.9968470267212406
ethereum,8929,1,119826,120204,0.9968553459119497
ethereum,8996,1,119827,120204,0.9968636651026588
ethereum,9036,1,119828,120204,0.996871984293368
ethereum,9078,1,119829,120204,0.9968803034840771
ethereum,9198,1,119830,120204,0.9968886226747862
ethereum,9266,1,119831,120204,0.9968969418654954
ethereum,9306,1,119832,120204,0.9969052610562045
ethereum,9325,1,119833,120204,0.9969135802469136
ethereum,9391,1,119834,120204,0.9969218994376227
ethereum,9408,1,119835,120204,0.9969302186283319
ethereum,9526,1,119836,120204,0.996938537819041
ethereum,9605,1,119837,120204,0.99694685700975
ethereum,9707,1,119838,120204,0.9969551762004593
ethereum,9711,1,119839,120204,0.9969634953911684
ethereum,9734,1,119840,120204,0.9969718145818774
ethereum,9741,1,119841,120204,0.9969801337725867
ethereum,9744,1,119842,120204,0.9969884529632957
ethereum,9745,1,119843,120204,0.9969967721540048
ethereum,9800,1,119844,120204,0.9970050913447139
ethereum,9826,1,119845,120204,0.9970134105354231
ethereum,9838,1,119846,120204,0.9970217297261322
ethereum,9966,1,119847,120204,0.9970300489168413
ethereum,9993,1,119848,120204,0.9970383681075505
ethereum,10000,1,119849,120204,0.9970466872982596
ethereum,10007,1,119850,120204,0.9970550064889687
ethereum,10017,1,119851,120204,0.9970633256796779
ethereum,10040,1,119852,120204,0.997071644870387
ethereum,10053,1,119853,120204,0.9970799640610961
ethereum,10100,1,119854,120204,0.9970882832518053
ethereum,10150,1,119855,120204,0.9970966024425144
ethereum,10179,1,119856,120204,0.9971049216332235
ethereum,10200,1,119857,120204,0.9971132408239326
ethereum,10225,1,119858,120204,0.9971215600146418
ethereum,10231,1,119859,120204,0.9971298792053509
ethereum,10255,1,119860,120204,0.99713819839606
ethereum,10277,1,119861,120204,0.9971465175867692
ethereum,10300,1,119862,120204,0.9971548367774783
ethereum,10360,1,119863,120204,0.9971631559681874
ethereum,10368,1,119864,120204,0.9971714751588966
ethereum,10429,1,119865,120204,0.9971797943496057
ethereum,10454,1,119866,120204,0.9971881135403148
ethereum,10500,1,119867,120204,0.9971964327310239
ethereum,10636,1,119868,120204,0.9972047519217331
ethereum,10638,1,119869,120204,0.9972130711124422
ethereum,10698,1,119870,120204,0.9972213903031513
ethereum,10713,1,119871,120204,0.9972297094938605
ethereum,10804,1,119872,120204,0.9972380286845696
ethereum,10857,1,119873,120204,0.9972463478752787
ethereum,10899,1,119874,120204,0.9972546670659879
ethereum,11017,1,119875,120204,0.997262986256697
ethereum,11076,1,119876,120204,0.997271305447406
ethereum,11120,1,119877,120204,0.9972796246381153
ethereum,11151,1,119878,120204,0.9972879438288244
ethereum,11214,1,119879,120204,0.9972962630195334
ethereum,11340,1,119880,120204,0.9973045822102425
ethereum,11375,1,119881,120204,0.9973129014009517
ethereum,11547,1,119882,120204,0.9973212205916608
ethereum,11600,1,119883,120204,0.9973295397823699
ethereum,11630,1,119884,120204,0.9973378589730791
ethereum,11697,1,119885,120204,0.9973461781637882
ethereum,11725,1,119886,120204,0.9973544973544973
ethereum,11900,1,119887,120204,0.9973628165452065
ethereum,11950,1,119888,120204,0.9973711357359156
ethereum,12165,1,119889,120204,0.9973794549266247
ethereum,12190,1,119890,120204,0.9973877741173338
ethereum,12191,1,119891,120204,0.997396093308043
ethereum,12264,1,119892,120204,0.9974044124987521
ethereum,12307,1,119893,120204,0.9974127316894612
ethereum,12336,1,119894,120204,0.9974210508801704
ethereum,12460,1,119895,120204,0.9974293700708795
ethereum,12700,1,119896,120204,0.9974376892615886
ethereum,12706,1,119897,120204,0.9974460084522978
ethereum,12724,1,119898,120204,0.9974543276430069
ethereum,12775,1,119899,120204,0.997462646833716
ethereum,12778,1,119900,120204,0.9974709660244252
ethereum,12880,1,119901,120204,0.9974792852151343
ethereum,13046,1,119902,120204,0.9974876044058434
ethereum,13121,1,119903,120204,0.9974959235965525
ethereum,13272,1,119904,120204,0.9975042427872617
ethereum,13300,1,119905,120204,0.9975125619779708
ethereum,13314,1,119906,120204,0.9975208811686799
ethereum,13401,1,119907,120204,0.9975292003593891
ethereum,13572,1,119908,120204,0.9975375195500982
ethereum,13627,1,119909,120204,0.9975458387408073
ethereum,13816,1,119910,120204,0.9975541579315165
ethereum,13910,1,119911,120204,0.9975624771222256
ethereum,14008,1,119912,120204,0.9975707963129347
ethereum,14040,1,119913,120204,0.9975791155036438
ethereum,14124,1,119914,120204,0.997587434694353
ethereum,14341,1,119915,120204,0.997595753885062
ethereum,14633,1,119916,120204,0.9976040730757711
ethereum,14647,1,119917,120204,0.9976123922664804
ethereum,14692,1,119918,120204,0.9976207114571894
ethereum,14696,1,119919,120204,0.9976290306478985
ethereum,14763,1,119920,120204,0.9976373498386077
ethereum,14804,1,119921,120204,0.9976456690293168
ethereum,14860,1,119922,120204,0.9976539882200259
ethereum,15010,1,119923,120204,0.9976623074107351
ethereum,15143,1,119924,120204,0.9976706266014442
ethereum,15351,1,119925,120204,0.9976789457921533
ethereum,15448,1,119926,120204,0.9976872649828624
ethereum,15456,1,119927,120204,0.9976955841735716
ethereum,15674,1,119928,120204,0.9977039033642807
ethereum,15972,1,119929,120204,0.9977122225549898
ethereum,16005,1,119930,120204,0.997720541745699
ethereum,16178,1,119931,120204,0.9977288609364081
ethereum,16380,1,119932,120204,0.9977371801271172
ethereum,16410,1,119933,120204,0.9977454993178264
ethereum,16441,1,119934,120204,0.9977538185085355
ethereum,16726,1,119935,120204,0.9977621376992446
ethereum,16821,1,119936,120204,0.9977704568899537
ethereum,16918,1,119937,120204,0.9977787760806629
ethereum,16950,1,119938,120204,0.997787095271372
ethereum,17000,1,119939,120204,0.9977954144620811
ethereum,17068,1,119940,120204,0.9978037336527903
ethereum,17089,1,119941,120204,0.9978120528434994
ethereum,17116,1,119942,120204,0.9978203720342085
ethereum,17202,1,119943,120204,0.9978286912249177
ethereum,17228,1,119944,120204,0.9978370104156268
ethereum,17307,1,119945,120204,0.9978453296063359
ethereum,17400,1,119946,120204,0.9978536487970451
ethereum,17498,1,119947,120204,0.9978619679877542
ethereum,17556,1,119948,120204,0.9978702871784633
ethereum,17652,1,119949,120204,0.9978786063691724
ethereum,17900,1,119950,120204,0.9978869255598816
ethereum,17911,1,119951,120204,0.9978952447505907
ethereum,17912,1,119952,120204,0.9979035639412998
ethereum,18026,1,119953,120204,0.997911883132009
ethereum,18079,1,119954,120204,0.997920202322718
ethereum,18102,1,119955,120204,0.9979285215134271
ethereum,18354,1,119956,120204,0.9979368407041364
ethereum,18412,1,119957,120204,0.9979451598948454
ethereum,18468,1,119958,120204,0.9979534790855545
ethereum,18576,1,119959,120204,0.9979617982762636
ethereum,18608,1,119960,120204,0.9979701174669728
ethereum,18610,1,119961,120204,0.9979784366576819
ethereum,18651,1,119962,120204,0.997986755848391
ethereum,18784,1,119963,120204,0.9979950750391002
ethereum,18831,1,119964,120204,0.9980033942298093
ethereum,19050,1,119965,120204,0.9980117134205184
ethereum,19073,1,119966,120204,0.9980200326112276
ethereum,19168,1,119967,120204,0.9980283518019367
ethereum,19260,1,119968,120204,0.9980366709926458
ethereum,19404,1,119969,120204,0.998044990183355
ethereum,19858,1,119970,120204,0.9980533093740641
ethereum,19881,1,119971,120204,0.9980616285647732
ethereum,19980,1,119972,120204,0.9980699477554823
ethereum,20240,1,119973,120204,0.9980782669461915
ethereum,20245,1,119974,120204,0.9980865861369006
ethereum,20258,1,119975,120204,0.9980949053276097
ethereum,20300,1,119976,120204,0.9981032245183189
ethereum,20730,1,119977,120204,0.998111543709028
ethereum,20853,1,119978,120204,0.9981198628997371
ethereum,20874,1,119979,120204,0.9981281820904463
ethereum,20905,1,119980,120204,0.9981365012811554
ethereum,20946,1,119981,120204,0.9981448204718645
ethereum,20948,1,119982,120204,0.9981531396625736
ethereum,20990,1,119983,120204,0.9981614588532828
ethereum,21040,1,119984,120204,0.9981697780439919
ethereum,21046,1,119985,120204,0.998178097234701
ethereum,21244,1,119986,120204,0.9981864164254102
ethereum,21591,1,119987,120204,0.9981947356161193
ethereum,21613,1,119988,120204,0.9982030548068284
ethereum,21672,1,119989,120204,0.9982113739975376
ethereum,21677,1,119990,120204,0.9982196931882467
ethereum,21831,1,119991,120204,0.9982280123789558
ethereum,21840,1,119992,120204,0.9982363315696648
ethereum,21935,1,119993,120204,0.998244650760374
ethereum,22000,1,119994,120204,0.9982529699510831
ethereum,22375,1,119995,120204,0.9982612891417922
ethereum,22395,1,119996,120204,0.9982696083325014
ethereum,22400,1,119997,120204,0.9982779275232105
ethereum,22491,1,119998,120204,0.9982862467139196
ethereum,22560,1,119999,120204,0.9982945659046288
ethereum,22600,1,120000,120204,0.9983028850953379
ethereum,22685,1,120001,120204,0.998311204286047
ethereum,22721,1,120002,120204,0.9983195234767562
ethereum,22764,1,120003,120204,0.9983278426674653
ethereum,22872,1,120004,120204,0.9983361618581744
ethereum,22925,1,120005,120204,0.9983444810488835
ethereum,22933,1,120006,120204,0.9983528002395927
ethereum,23176,1,120007,120204,0.9983611194303018
ethereum,23180,1,120008,120204,0.9983694386210109
ethereum,23183,1,120009,120204,0.9983777578117201
ethereum,23268,1,120010,120204,0.9983860770024292
ethereum,23327,1,120011,120204,0.9983943961931383
ethereum,23480,1,120012,120204,0.9984027153838475
ethereum,23520,1,120013,120204,0.9984110345745566
ethereum,24410,1,120014,120204,0.9984193537652657
ethereum,24860,1,120015,120204,0.9984276729559748
ethereum,24864,1,120016,120204,0.998435992146684
ethereum,25043,1,120017,120204,0.9984443113373931
ethereum,25515,1,120018,120204,0.9984526305281022
ethereum,25640,1,120019,120204,0.9984609497188114
ethereum,25694,1,120020,120204,0.9984692689095205
ethereum,26038,1,120021,120204,0.9984775881002296
ethereum,26469,1,120022,120204,0.9984859072909388
ethereum,27020,1,120023,120204,0.9984942264816479
ethereum,27485,1,120024,120204,0.998502545672357
ethereum,27629,1,120025,120204,0.9985108648630662
ethereum,27728,1,120026,120204,0.9985191840537753
ethereum,27801,1,120027,120204,0.9985275032444844
ethereum,27875,1,120028,120204,0.9985358224351935
ethereum,27933,1,120029,120204,0.9985441416259027
ethereum,28138,1,120030,120204,0.9985524608166118
ethereum,28425,1,120031,120204,0.9985607800073208
ethereum,28549,1,120032,120204,0.99856909919803
ethereum,28665,1,120033,120204,0.9985774183887391
ethereum,28822,1,120034,120204,0.9985857375794482
ethereum,29054,1,120035,120204,0.9985940567701574
ethereum,29500,1,120036,120204,0.9986023759608665
ethereum,29600,1,120037,120204,0.9986106951515756
ethereum,29862,1,120038,120204,0.9986190143422847
ethereum,29988,1,120039,120204,0.9986273335329939
ethereum,30335,1,120040,120204,0.998635652723703
ethereum,30408,1,120041,120204,0.9986439719144121
ethereum,30476,1,120042,120204,0.9986522911051213
ethereum,30500,1,120043,120204,0.9986606102958304
ethereum,30501,1,120044,120204,0.9986689294865395
ethereum,30659,1,120045,120204,0.9986772486772487
ethereum,30838,1,120046,120204,0.9986855678679578
ethereum,31364,1,120047,120204,0.9986938870586669
ethereum,31672,1,120048,120204,0.9987022062493761
ethereum,31872,1,120049,120204,0.9987105254400852
ethereum,31953,1,120050,120204,0.9987188446307943
ethereum,32450,1,120051,120204,0.9987271638215034
ethereum,32460,1,120052,120204,0.9987354830122126
ethereum,32633,1,120053,120204,0.9987438022029217
ethereum,32912,1,120054,120204,0.9987521213936308
ethereum,33014,1,120055,120204,0.99876044058434
ethereum,33174,1,120056,120204,0.9987687597750491
ethereum,33683,1,120057,120204,0.9987770789657582
ethereum,33708,1,120058,120204,0.9987853981564674
ethereum,34148,1,120059,120204,0.9987937173471765
ethereum,34181,1,120060,120204,0.9988020365378856
ethereum,34383,1,120061,120204,0.9988103557285947
ethereum,34403,1,120062,120204,0.9988186749193039
ethereum,34673,1,120063,120204,0.998826994110013
ethereum,34929,1,120064,120204,0.9988353133007221
ethereum,35253,1,120065,120204,0.9988436324914313
ethereum,35530,1,120066,120204,0.9988519516821404
ethereum,37480,1,120067,120204,0.9988602708728495
ethereum,37539,1,120068,120204,0.9988685900635587
ethereum,37597,1,120069,120204,0.9988769092542678
ethereum,38104,1,120070,120204,0.9988852284449768
ethereum,38311,1,120071,120204,0.998893547635686
ethereum,38340,1,120072,120204,0.9989018668263951
ethereum,38476,1,120073,120204,0.9989101860171042
ethereum,38525,1,120074,120204,0.9989185052078133
ethereum,39297,1,120075,120204,0.9989268243985225
ethereum,39446,1,120076,120204,0.9989351435892316
ethereum,39503,1,120077,120204,0.9989434627799407
ethereum,42217,1,120078,120204,0.9989517819706499
ethereum,42912,1,120079,120204,0.998960101161359
ethereum,42928,1,120080,120204,0.9989684203520681
ethereum,43470,1,120081,120204,0.9989767395427773
ethereum,43804,1,120082,120204,0.9989850587334864
ethereum,43857,1,120083,120204,0.9989933779241955
ethereum,45528,1,120084,120204,0.9990016971149046
ethereum,46417,1,120085,120204,0.9990100163056138
ethereum,46546,1,120086,120204,0.9990183354963229
ethereum,46700,1,120087,120204,0.999026654687032
ethereum,47656,1,120088,120204,0.9990349738777412
ethereum,48565,1,120089,120204,0.9990432930684503
ethereum,49560,1,120090,120204,0.9990516122591594
ethereum,51456,1,120091,120204,0.9990599314498686
ethereum,52265,1,120092,120204,0.9990682506405777
ethereum,52512,1,120093,120204,0.9990765698312868
ethereum,53333,1,120094,120204,0.999084889021996
ethereum,53896,1,120095,120204,0.9990932082127051
ethereum,54000,1,120096,120204,0.9991015274034142
ethereum,54448,1,120097,120204,0.9991098465941233
ethereum,55230,1,120098,120204,0.9991181657848325
ethereum,55616,1,120099,120204,0.9991264849755416
ethereum,56296,1,120100,120204,0.9991348041662507
ethereum,56631,1,120101,120204,0.9991431233569599
ethereum,58113,1,120102,120204,0.999151442547669
ethereum,58143,1,120103,120204,0.9991597617383781
ethereum,58152,2,120105,120204,0.9991764001197964
ethereum,58253,1,120106,120204,0.9991847193105055
ethereum,60001,1,120107,120204,0.9991930385012145
ethereum,62468,1,120108,120204,0.9992013576919238
ethereum,62801,1,120109,120204,0.9992096768826328
ethereum,64308,1,120110,120204,0.9992179960733419
ethereum,64489,1,120111,120204,0.9992263152640511
ethereum,66400,1,120112,120204,0.9992346344547602
ethereum,68400,1,120113,120204,0.9992429536454693
ethereum,68601,1,120114,120204,0.9992512728361785
ethereum,69932,1,120115,120204,0.9992595920268876
ethereum,70801,1,120116,120204,0.9992679112175967
ethereum,72100,1,120117,120204,0.9992762304083059
ethereum,72610,1,120118,120204,0.999284549599015
ethereum,73839,1,120119,120204,0.9992928687897241
ethereum,73923,1,120120,120204,0.9993011879804332
ethereum,74620,1,120121,120204,0.9993095071711424
ethereum,78162,1,120122,120204,0.9993178263618515
ethereum,78267,1,120123,120204,0.9993261455525606
ethereum,79335,1,120124,120204,0.9993344647432698
ethereum,80173,1,120125,120204,0.9993427839339789
ethereum,80997,1,120126,120204,0.999351103124688
ethereum,81331,1,120127,120204,0.9993594223153972
ethereum,84649,1,120128,120204,0.9993677415061063
ethereum,86296,1,120129,120204,0.9993760606968154
ethereum,87158,1,120130,120204,0.9993843798875245
ethereum,88015,1,120131,120204,0.9993926990782337
ethereum,91517,1,120132,120204,0.9994010182689428
ethereum,92862,1,120133,120204,0.9994093374596519
ethereum,94542,1,120134,120204,0.9994176566503611
ethereum,95150,1,120135,120204,0.9994259758410702
ethereum,99844,1,120136,120204,0.9994342950317793
ethereum,100000,1,120137,120204,0.9994426142224885
ethereum,101232,1,120138,120204,0.9994509334131976
ethereum,102400,1,120139,120204,0.9994592526039067
ethereum,103346,1,120140,120204,0.9994675717946159
ethereum,103510,1,120141,120204,0.999475890985325
ethereum,104138,1,120142,120204,0.9994842101760341
ethereum,107431,1,120143,120204,0.9994925293667432
ethereum,107648,1,120144,120204,0.9995008485574524
ethereum,109231,1,120145,120204,0.9995091677481615
ethereum,114686,1,120146,120204,0.9995174869388705
ethereum,117900,1,120147,120204,0.9995258061295798
ethereum,118725,1,120148,120204,0.9995341253202888
ethereum,119448,1,120149,120204,0.9995424445109979
ethereum,120666,1,120150,120204,0.9995507637017071
ethereum,121592,1,120151,120204,0.9995590828924162
ethereum,126106,1,120152,120204,0.9995674020831253
ethereum,127232,1,120153,120204,0.9995757212738344
ethereum,136584,1,120154,120204,0.9995840404645436
ethereum,142581,1,120155,120204,0.9995923596552527
ethereum,150888,1,120156,120204,0.9996006788459618
ethereum,162241,1,120157,120204,0.999608998036671
ethereum,183515,1,120158,120204,0.9996173172273801
ethereum,183804,1,120159,120204,0.9996256364180892
ethereum,193346,1,120160,120204,0.9996339556087984
ethereum,207984,1,120161,120204,0.9996422747995075
ethereum,211825,1,120162,120204,0.9996505939902166
ethereum,222154,1,120163,120204,0.9996589131809258
ethereum,224600,1,120164,120204,0.9996672323716349
ethereum,236335,1,120165,120204,0.999675551562344
ethereum,243255,1,120166,120204,0.9996838707530531
ethereum,268527,1,120167,120204,0.9996921899437623
ethereum,270380,1,120168,120204,0.9997005091344714
ethereum,273260,1,120169,120204,0.9997088283251805
ethereum,292285,1,120170,120204,0.9997171475158897
ethereum,294462,1,120171,120204,0.9997254667065988
ethereum,312671,1,120172,120204,0.9997337858973079
ethereum,333422,1,120173,120204,0.9997421050880171
ethereum,334910,1,120174,120204,0.9997504242787262
ethereum,337928,1,120175,120204,0.9997587434694353
ethereum,360333,1,120176,120204,0.9997670626601444
ethereum,370163,1,120177,120204,0.9997753818508536
ethereum,406556,1,120178,120204,0.9997837010415627
ethereum,423600,1,120179,120204,0.9997920202322718
ethereum,427412,1,120180,120204,0.999800339422981
ethereum,429605,1,120181,120204,0.9998086586136901
ethereum,458043,1,120182,120204,0.9998169778043992
ethereum,477444,1,120183,120204,0.9998252969951084
ethereum,481313,1,120184,120204,0.9998336161858175
ethereum,682020,1,120185,120204,0.9998419353765265
ethereum,722020,1,120186,120204,0.9998502545672358
ethereum,727425,1,120187,120204,0.9998585737579448
ethereum,743646,1,120188,120204,0.9998668929486539
ethereum,836791,1,120189,120204,0.999875212139363
ethereum,939699,1,120190,120204,0.9998835313300722
ethereum,952859,1,120191,120204,0.9998918505207813
ethereum,1023035,1,120192,120204,0.9999001697114904
ethereum,1049380,1,120193,120204,0.9999084889021996
ethereum,1220979,1,120194,120204,0.9999168080929087
ethereum,1237534,1,120195,120204,0.9999251272836178
ethereum,1548297,1,120196,120204,0.999933446474327
ethereum,1586334,1,120197,120204,0.9999417656650361
ethereum,1633386,1,120198,120204,0.9999500848557452
ethereum,1647068,1,120199,120204,0.9999584040464543
ethereum,1753886,1,120200,120204,0.9999667232371635
ethereum,6627699,1,120201,120204,0.9999750424278726
ethereum,6902508,1,120202,120204,0.9999833616185817
ethereum,7302028,1,120203,120204,0.9999916808092909
ethereum,10345662,1,120204,120204,1.0
polygon,1,45069,45069,69258,0.6507407086545959
polygon,2,6133,51202,69258,0.7392936556065726
polygon,3,2902,54104,69258,0.7811949522076872
polygon,4,1240,55344,69258,0.7990990210517197
polygon,5,2631,57975,69258,0.8370874122845015
polygon,6,3822,61797,69258,0.8922723728666725
polygon,7,443,62240,69258,0.898668745848855
polygon,8,610,62850,69258,0.9074763926189032
polygon,9,311,63161,69258,0.9119668485951081
polygon,10,556,63717,69258,0.9199948020445291
polygon,11,202,63919,69258,0.9229114326142829
polygon,12,225,64144,69258,0.926160154783563
polygon,13,133,64277,69258,0.9280805105547374
polygon,14,185,64462,69258,0.9307516821161455
polygon,15,151,64613,69258,0.9329319356608623
polygon,16,147,64760,69258,0.935054434144792
polygon,17,91,64851,69258,0.9363683617777008
polygon,18,110,64961,69258,0.9379566259493488
polygon,19,77,65038,69258,0.9390684108695024
polygon,20,159,65197,69258,0.9413641745357937
polygon,21,102,65299,69258,0.9428369285858673
polygon,22,57,65356,69258,0.9436599382020849
polygon,23,52,65408,69258,0.9444107539923186
polygon,24,60,65468,69258,0.9452770799041266
polygon,25,51,65519,69258,0.9460134569291634
polygon,26,54,65573,69258,0.9467931502497906
polygon,27,50,65623,69258,0.9475150885096306
polygon,28,51,65674,69258,0.9482514655346674
polygon,29,30,65704,69258,0.9486846284905714
polygon,30,695,66399,69258,0.9587195703023478
polygon,31,50,66449,69258,0.9594415085621878
polygon,32,53,66502,69258,0.9602067631176182
polygon,33,29,66531,69258,0.9606254873083254
polygon,34,36,66567,69258,0.9611452828554102
polygon,35,35,66602,69258,0.9616506396372982
polygon,36,38,66640,69258,0.9621993127147767
polygon,37,28,66668,69258,0.9626035981402871
polygon,38,25,66693,69258,0.9629645672702071
polygon,39,29,66722,69258,0.9633832914609143
polygon,40,43,66765,69258,0.9640041583643767
polygon,41,23,66788,69258,0.9643362499639031
polygon,42,29,66817,69258,0.9647549741546103
polygon,43,26,66843,69258,0.9651303820497271
polygon,44,25,66868,69258,0.9654913511796471
polygon,45,26,66894,69258,0.9658667590747639
polygon,46,20,66914,69258,0.9661555343786999
polygon,47,15,66929,69258,0.966372115856652
polygon,48,19,66948,69258,0.9666464523953912
polygon,49,10,66958,69258,0.9667908400473592
polygon,50,39,66997,69258,0.9673539518900344
polygon,51,16,67013,69258,0.9675849721331832
polygon,52,22,67035,69258,0.9679026249675128
polygon,53,11,67046,69258,0.9680614513846776
polygon,54,30,67076,69258,0.9684946143405816
polygon,55,10,67086,69258,0.9686390019925496
polygon,56,15,67101,69258,0.9688555834705016
polygon,57,10,67111,69258,0.9689999711224696
polygon,58,13,67124,69258,0.969187675070028
polygon,59,5,67129,69258,0.969259868896012
polygon,60,27,67156,69258,0.9696497155563256
polygon,61,12,67168,69258,0.9698229807386872
polygon,62,12,67180,69258,0.9699962459210488
polygon,63,12,67192,69258,0.9701695111034104
polygon,64,12,67204,69258,0.970342776285772
polygon,65,18,67222,69258,0.9706026740593144
polygon,66,12,67234,69258,0.970775939241676
polygon,67,13,67247,69258,0.9709636431892344
polygon,68,6,67253,69258,0.9710502757804153
polygon,69,16,67269,69258,0.9712812960235641
polygon,70,8,67277,69258,0.9713968061451385
polygon,71,10,67287,69258,0.9715411937971065
polygon,72,10,67297,69258,0.9716855814490745
polygon,73,5,67302,69258,0.9717577752750585
polygon,74,6,67308,69258,0.9718444078662393
polygon,75,12,67320,69258,0.9720176730486009
polygon,76,9,67329,69258,0.9721476219353721
polygon,77,3,67332,69258,0.9721909382309625
polygon,78,7,67339,69258,0.9722920095873401
polygon,79,12,67351,69258,0.9724652747697017
polygon,80,13,67364,69258,0.9726529787172601
polygon,81,12,67376,69258,0.9728262438996217
polygon,82,14,67390,69258,0.9730283866123769
polygon,83,8,67398,69258,0.9731438967339513
polygon,84,12,67410,69258,0.9733171619163129
polygon,85,10,67420,69258,0.9734615495682809
polygon,86,3,67423,69258,0.9735048658638713
polygon,87,10,67433,69258,0.9736492535158393
polygon,88,7,67440,69258,0.9737503248722169
polygon,89,8,67448,69258,0.9738658349937913
polygon,90,5,67453,69258,0.9739380288197753
polygon,91,5,67458,69258,0.9740102226457593
polygon,92,12,67470,69258,0.9741834878281209
polygon,93,8,67478,69258,0.9742989979496953
polygon,94,9,67487,69258,0.9744289468364665
polygon,95,4,67491,69258,0.9744867018972537
polygon,96,8,67499,69258,0.9746022120188281
polygon,97,11,67510,69258,0.9747610384359929
polygon,98,7,67517,69258,0.9748621097923705
polygon,99,5,67522,69258,0.9749343036183545
polygon,100,798,68320,69258,0.9864564382454013
polygon,101,6,68326,69258,0.9865430708365821
polygon,102,5,68331,69258,0.9866152646625661
polygon,103,4,68335,69258,0.9866730197233533
polygon,104,11,68346,69258,0.9868318461405181
polygon,105,5,68351,69258,0.9869040399665021
polygon,106,6,68357,69258,0.9869906725576829
polygon,107,4,68361,69258,0.9870484276184701
polygon,108,3,68364,69258,0.9870917439140605
polygon,109,2,68366,69258,0.9871206214444541
polygon,110,5,68371,69258,0.9871928152704381
polygon,111,5,68376,69258,0.9872650090964221
polygon,112,5,68381,69258,0.9873372029224061
polygon,113,5,68386,69258,0.9874093967483901
polygon,114,3,68389,69258,0.9874527130439805
polygon,115,7,68396,69258,0.9875537844003581
polygon,116,6,68402,69258,0.9876404169915389
polygon,117,2,68404,69258,0.9876692945219325
polygon,118,11,68415,69258,0.9878281209390973
polygon,120,9,68424,69258,0.9879580698258685
polygon,121,4,68428,69258,0.9880158248866557
polygon,122,4,68432,69258,0.9880735799474429
polygon,123,5,68437,69258,0.9881457737734269
polygon,124,1,68438,69258,0.9881602125386237
polygon,125,2,68440,69258,0.9881890900690173
polygon,126,4,68444,69258,0.9882468451298045
polygon,127,1,68445,69258,0.9882612838950013
polygon,128,4,68449,69258,0.9883190389557885
polygon,130,5,68454,69258,0.9883912327817725
polygon,131,2,68456,69258,0.9884201103121661
polygon,132,5,68461,69258,0.9884923041381501
polygon,133,2,68463,69258,0.9885211816685437
polygon,134,2,68465,69258,0.9885500591989373
polygon,135,2,68467,69258,0.988578936729331
polygon,136,8,68475,69258,0.9886944468509054
polygon,137,1,68476,69258,0.9887088856161022
polygon,138,4,68480,69258,0.9887666406768894
polygon,139,6,68486,69258,0.9888532732680702
polygon,140,5,68491,69258,0.9889254670940542
polygon,141,7,68498,69258,0.9890265384504318
polygon,142,2,68500,69258,0.9890554159808254
polygon,143,2,68502,69258,0.989084293511219
polygon,144,3,68505,69258,0.9891276098068094
polygon,145,4,68509,69258,0.9891853648675966
polygon,146,6,68515,69258,0.9892719974587774
polygon,147,4,68519,69258,0.9893297525195646
polygon,148,1,68520,69258,0.9893441912847614
polygon,149,5,68525,69258,0.9894163851107454
polygon,150,9,68534,69258,0.9895463339975166
polygon,151,4,68538,69258,0.9896040890583038
polygon,152,5,68543,69258,0.9896762828842878
polygon,153,2,68545,69258,0.9897051604146814
polygon,154,2,68547,69258,0.989734037945075
polygon,155,3,68550,69258,0.9897773542406654
polygon,156,1,68551,69258,0.9897917930058622
polygon,157,2,68553,69258,0.9898206705362558
polygon,158,3,68556,69258,0.9898639868318462
polygon,159,4,68560,69258,0.9899217418926334
polygon,160,4,68564,69258,0.9899794969534206
polygon,162,1,68565,69258,0.9899939357186174
polygon,163,1,68566,69258,0.9900083744838142
polygon,164,2,68568,69258,0.9900372520142078
polygon,165,4,68572,69258,0.990095007074995
polygon,166,1,68573,69258,0.9901094458401918
polygon,167,1,68574,69258,0.9901238846053886
polygon,169,3,68577,69258,0.990167200900979
polygon,170,1,68578,69258,0.9901816396661758
polygon,171,2,68580,69258,0.9902105171965694
polygon,172,2,68582,69258,0.990239394726963
polygon,174,4,68586,69258,0.9902971497877502
polygon,175,3,68589,69258,0.9903404660833406
polygon,176,2,68591,69258,0.9903693436137342
polygon,177,1,68592,69258,0.990383782378931
polygon,178,3,68595,69258,0.9904270986745214
polygon,180,5,68600,69258,0.9904992925005054
polygon,181,2,68602,69258,0.990528170030899
polygon,182,3,68605,69258,0.9905714863264894
polygon,185,2,68607,69258,0.990600363856883
polygon,186,3,68610,69258,0.9906436801524734
polygon,187,1,68611,69258,0.9906581189176702
polygon,188,2,68613,69258,0.9906869964480638
polygon,189,2,68615,69258,0.9907158739784574
polygon,190,1,68616,69258,0.9907303127436542
polygon,191,2,68618,69258,0.9907591902740478
polygon,192,1,68619,69258,0.9907736290392446
polygon,193,4,68623,69258,0.9908313841000318
polygon,195,4,68627,69258,0.990889139160819
polygon,196,2,68629,69258,0.9909180166912126
polygon,197,1,68630,69258,0.9909324554564094
polygon,198,3,68633,69258,0.9909757717519998
polygon,199,2,68635,69258,0.9910046492823934
polygon,200,6,68641,69258,0.9910912818735742
polygon,202,2,68643,69258,0.9911201594039678
polygon,204,4,68647,69258,0.991177914464755
polygon,205,2,68649,69258,0.9912067919951486
polygon,208,1,68650,69258,0.9912212307603454
polygon,209,1,68651,69258,0.9912356695255422
polygon,210,2,68653,69258,0.9912645470559358
polygon,211,2,68655,69258,0.9912934245863294
polygon,212,2,68657,69258,0.991322302116723
polygon,213,3,68660,69258,0.9913656184123134
polygon,214,1,68661,69258,0.9913800571775102
polygon,215,2,68663,69258,0.9914089347079038
polygon,216,5,68668,69258,0.9914811285338878
polygon,217,1,68669,69258,0.9914955672990846
polygon,218,1,68670,69258,0.9915100060642814
polygon,219,3,68673,69258,0.9915533223598718
polygon,221,1,68674,69258,0.9915677611250686
polygon,223,2,68676,69258,0.9915966386554622
polygon,224,2,68678,69258,0.9916255161858558
polygon,225,3,68681,69258,0.9916688324814462
polygon,227,2,68683,69258,0.9916977100118398
polygon,228,2,68685,69258,0.9917265875422334
polygon,229,1,68686,69258,0.9917410263074302
polygon,232,1,68687,69258,0.991755465072627
polygon,233,2,68689,69258,0.9917843426030206
polygon,234,1,68690,69258,0.9917987813682174
polygon,236,3,68693,69258,0.9918420976638078
polygon,237,1,68694,69258,0.9918565364290046
polygon,238,1,68695,69258,0.9918709751942014
polygon,239,1,68696,69258,0.9918854139593982
polygon,240,2,68698,69258,0.9919142914897918
polygon,241,1,68699,69258,0.9919287302549886
polygon,242,1,68700,69258,0.9919431690201854
polygon,243,1,68701,69258,0.9919576077853822
polygon,244,3,68704,69258,0.9920009240809726
polygon,245,2,68706,69258,0.9920298016113662
polygon,246,2,68708,69258,0.9920586791417598
polygon,247,1,68709,69258,0.9920731179069566
polygon,248,3,68712,69258,0.992116434202547
polygon,249,1,68713,69258,0.9921308729677438
polygon,250,3,68716,69258,0.9921741892633342
polygon,251,1,68717,69258,0.992188628028531
polygon,252,2,68719,69258,0.9922175055589246
polygon,254,1,68720,69258,0.9922319443241214
polygon,255,2,68722,69258,0.992260821854515
polygon,256,1,68723,69258,0.9922752606197118
polygon,257,1,68724,69258,0.9922896993849086
polygon,261,1,68725,69258,0.9923041381501054
polygon,262,2,68727,69258,0.992333015680499
polygon,263,2,68729,69258,0.9923618932108926
polygon,264,1,68730,69258,0.9923763319760894
polygon,266,1,68731,69258,0.9923907707412862
polygon,267,1,68732,69258,0.992405209506483
polygon,268,2,68734,69258,0.9924340870368766
polygon,271,2,68736,69258,0.9924629645672702
polygon,272,1,68737,69258,0.992477403332467
polygon,274,1,68738,69258,0.9924918420976638
polygon,275,4,68742,69258,0.992549597158451
polygon,277,1,68743,69258,0.9925640359236478
polygon,278,1,68744,69258,0.9925784746888446
polygon,279,2,68746,69258,0.9926073522192382
polygon,282,1,68747,69258,0.992621790984435
polygon,289,2,68749,69258,0.9926506685148286
polygon,290,2,68751,69258,0.9926795460452222
polygon,291,1,68752,69258,0.992693984810419
polygon,294,1,68753,69258,0.9927084235756158
polygon,297,2,68755,69258,0.9927373011060094
polygon,298,1,68756,69258,0.9927517398712062
polygon,300,2,68758,69258,0.9927806174015998
polygon,301,1,68759,69258,0.9927950561667966
polygon,303,2,68761,69258,0.9928239336971902
polygon,304,2,68763,69258,0.9928528112275838
polygon,308,1,68764,69258,0.9928672499927806
polygon,310,1,68765,69258,0.9928816887579774
polygon,311,2,68767,69258,0.992910566288371
polygon,312,1,68768,69258,0.9929250050535678
polygon,313,2,68770,69258,0.9929538825839614
polygon,314,1,68771,69258,0.9929683213491582
polygon,315,1,68772,69258,0.992982760114355
polygon,318,2,68774,69258,0.9930116376447486
polygon,319,3,68777,69258,0.993054953940339
polygon,320,2,68779,69258,0.9930838314707326
polygon,321,3,68782,69258,0.993127147766323
polygon,322,1,68783,69258,0.9931415865315198
polygon,323,2,68785,69258,0.9931704640619134
polygon,327,1,68786,69258,0.9931849028271102
polygon,329,1,68787,69258,0.993199341592307
polygon,336,1,68788,69258,0.9932137803575039
polygon,338,1,68789,69258,0.9932282191227007
polygon,339,1,68790,69258,0.9932426578878975
polygon,343,1,68791,69258,0.9932570966530943
polygon,344,1,68792,69258,0.993271535418291
polygon,345,2,68794,69258,0.9933004129486847
polygon,347,1,68795,69258,0.9933148517138815
polygon,348,2,68797,69258,0.993343729244275
polygon,350,1,68798,69258,0.9933581680094719
polygon,352,1,68799,69258,0.9933726067746687
polygon,353,1,68800,69258,0.9933870455398655
polygon,355,1,68801,69258,0.9934014843050623
polygon,356,1,68802,69258,0.993415923070259
polygon,358,2,68804,69258,0.9934448006006527
polygon,361,2,68806,69258,0.9934736781310463
polygon,362,2,68808,69258,0.9935025556614399
polygon,363,1,68809,69258,0.9935169944266367
polygon,364,1,68810,69258,0.9935314331918335
polygon,366,2,68812,69258,0.9935603107222271
polygon,367,1,68813,69258,0.9935747494874239
polygon,368,1,68814,69258,0.9935891882526207
polygon,369,3,68817,69258,0.9936325045482111
polygon,370,1,68818,69258,0.9936469433134079
polygon,371,2,68820,69258,0.9936758208438015
polygon,372,1,68821,69258,0.9936902596089983
polygon,374,1,68822,69258,0.9937046983741951
polygon,379,2,68824,69258,0.9937335759045887
polygon,380,1,68825,69258,0.9937480146697855
polygon,386,1,68826,69258,0.9937624534349823
polygon,388,2,68828,69258,0.9937913309653759
polygon,390,1,68829,69258,0.9938057697305727
polygon,392,1,68830,69258,0.9938202084957695
polygon,393,1,68831,69258,0.9938346472609663
polygon,396,1,68832,69258,0.9938490860261631
polygon,398,1,68833,69258,0.9938635247913599
polygon,399,1,68834,69258,0.9938779635565567
polygon,400,2,68836,69258,0.9939068410869503
polygon,404,1,68837,69258,0.9939212798521471
polygon,410,1,68838,69258,0.9939357186173439
polygon,411,1,68839,69258,0.9939501573825407
polygon,413,1,68840,69258,0.9939645961477375
polygon,419,1,68841,69258,0.9939790349129343
polygon,423,3,68844,69258,0.9940223512085247
polygon,425,1,68845,69258,0.9940367899737215
polygon,428,4,68849,69258,0.9940945450345087
polygon,430,1,68850,69258,0.9941089837997055
polygon,438,2,68852,69258,0.9941378613300991
polygon,439,1,68853,69258,0.9941523000952959
polygon,441,1,68854,69258,0.9941667388604927
polygon,446,1,68855,69258,0.9941811776256895
polygon,450,2,68857,69258,0.9942100551560831
polygon,456,3,68860,69258,0.9942533714516735
polygon,457,2,68862,69258,0.9942822489820671
polygon,460,1,68863,69258,0.9942966877472639
polygon,462,1,68864,69258,0.9943111265124607
polygon,463,1,68865,69258,0.9943255652776575
polygon,472,1,68866,69258,0.9943400040428543
polygon,473,1,68867,69258,0.9943544428080511
polygon,475,1,68868,69258,0.9943688815732479
polygon,477,1,68869,69258,0.9943833203384447
polygon,479,1,68870,69258,0.9943977591036415
polygon,484,1,68871,69258,0.9944121978688383
polygon,486,1,68872,69258,0.9944266366340351
polygon,494,1,68873,69258,0.9944410753992319
polygon,497,1,68874,69258,0.9944555141644287
polygon,498,1,68875,69258,0.9944699529296255
polygon,500,4,68879,69258,0.9945277079904127
polygon,501,1,68880,69258,0.9945421467556095
polygon,505,1,68881,69258,0.9945565855208063
polygon,506,2,68883,69258,0.9945854630511999
polygon,513,1,68884,69258,0.9945999018163967
polygon,514,2,68886,69258,0.9946287793467903
polygon,515,2,68888,69258,0.9946576568771839
polygon,517,1,68889,69258,0.9946720956423807
polygon,518,1,68890,69258,0.9946865344075775
polygon,526,1,68891,69258,0.9947009731727743
polygon,528,1,68892,69258,0.9947154119379711
polygon,537,1,68893,69258,0.9947298507031679
polygon,538,2,68895,69258,0.9947587282335615
polygon,539,1,68896,69258,0.9947731669987583
polygon,550,3,68899,69258,0.9948164832943487
polygon,559,2,68901,69258,0.9948453608247423
polygon,560,1,68902,69258,0.9948597995899391
polygon,563,1,68903,69258,0.9948742383551359
polygon,564,1,68904,69258,0.9948886771203327
polygon,565,1,68905,69258,0.9949031158855295
polygon,567,1,68906,69258,0.9949175546507263
polygon,570,1,68907,69258,0.9949319934159231
polygon,573,1,68908,69258,0.9949464321811199
polygon,578,1,68909,69258,0.9949608709463167
polygon,581,1,68910,69258,0.9949753097115135
polygon,582,1,68911,69258,0.9949897484767103
polygon,583,1,68912,69258,0.9950041872419071
polygon,584,1,68913,69258,0.9950186260071039
polygon,591,2,68915,69258,0.9950475035374975
polygon,595,1,68916,69258,0.9950619423026943
polygon,596,2,68918,69258,0.9950908198330879
polygon,597,1,68919,69258,0.9951052585982847
polygon,600,2,68921,69258,0.9951341361286783
polygon,604,1,68922,69258,0.9951485748938751
polygon,605,1,68923,69258,0.9951630136590719
polygon,606,2,68925,69258,0.9951918911894655
polygon,615,1,68926,69258,0.9952063299546623
polygon,616,1,68927,69258,0.9952207687198591
polygon,621,1,68928,69258,0.9952352074850559
polygon,622,1,68929,69258,0.9952496462502527
polygon,623,1,68930,69258,0.9952640850154495
polygon,625,1,68931,69258,0.9952785237806463
polygon,630,1,68932,69258,0.9952929625458431
polygon,633,1,68933,69258,0.9953074013110399
polygon,634,1,68934,69258,0.9953218400762367
polygon,636,1,68935,69258,0.9953362788414335
polygon,640,1,68936,69258,0.9953507176066303
polygon,642,1,68937,69258,0.9953651563718271
polygon,650,1,68938,69258,0.9953795951370239
polygon,654,2,68940,69258,0.9954084726674175
polygon,661,1,68941,69258,0.9954229114326143
polygon,662,1,68942,69258,0.9954373501978111
polygon,664,1,68943,69258,0.9954517889630079
polygon,679,1,68944,69258,0.9954662277282047
polygon,686,1,68945,69258,0.9954806664934015
polygon,693,1,68946,69258,0.9954951052585983
polygon,700,1,68947,69258,0.9955095440237951
polygon,702,1,68948,69258,0.9955239827889919
polygon,703,1,68949,69258,0.9955384215541887
polygon,707,6,68955,69258,0.9956250541453695
polygon,709,1,68956,69258,0.9956394929105663
polygon,710,1,68957,69258,0.9956539316757631
polygon,722,2,68959,69258,0.9956828092061567
polygon,728,1,68960,69258,0.9956972479713535
polygon,729,1,68961,69258,0.9957116867365503
polygon,731,1,68962,69258,0.9957261255017471
polygon,736,1,68963,69258,0.9957405642669439
polygon,738,1,68964,69258,0.9957550030321407
polygon,740,2,68966,69258,0.9957838805625343
polygon,742,2,68968,69258,0.9958127580929279
polygon,745,1,68969,69258,0.9958271968581247
polygon,751,1,68970,69258,0.9958416356233215
polygon,753,1,68971,69258,0.9958560743885183
polygon,754,1,68972,69258,0.9958705131537151
polygon,757,1,68973,69258,0.9958849519189119
polygon,758,1,68974,69258,0.9958993906841087
polygon,763,2,68976,69258,0.9959282682145023
polygon,769,1,68977,69258,0.9959427069796991
polygon,775,1,68978,69258,0.9959571457448959
polygon,781,1,68979,69258,0.9959715845100927
polygon,783,2,68981,69258,0.9960004620404863
polygon,796,1,68982,69258,0.9960149008056831
polygon,800,1,68983,69258,0.9960293395708799
polygon,801,1,68984,69258,0.9960437783360767
polygon,806,1,68985,69258,0.9960582171012735
polygon,814,1,68986,69258,0.9960726558664703
polygon,826,1,68987,69258,0.9960870946316671
polygon,831,1,68988,69258,0.9961015333968639
polygon,832,1,68989,69258,0.9961159721620607
polygon,834,2,68991,69258,0.9961448496924543
polygon,837,1,68992,69258,0.9961592884576511
polygon,840,1,68993,69258,0.9961737272228479
polygon,850,1,68994,69258,0.9961881659880447
polygon,854,1,68995,69258,0.9962026047532415
polygon,860,1,68996,69258,0.9962170435184383
polygon,861,1,68997,69258,0.9962314822836351
polygon,867,1,68998,69258,0.9962459210488319
polygon,875,1,68999,69258,0.9962603598140287
polygon,876,1,69000,69258,0.9962747985792255
polygon,878,1,69001,69258,0.9962892373444223
polygon,880,1,69002,69258,0.9963036761096191
polygon,900,1,69003,69258,0.9963181148748159
polygon,904,1,69004,69258,0.9963325536400127
polygon,908,1,69005,69258,0.9963469924052095
polygon,909,1,69006,69258,0.9963614311704063
polygon,913,1,69007,69258,0.9963758699356031
polygon,930,1,69008,69258,0.9963903087007999
polygon,932,1,69009,69258,0.9964047474659967
polygon,935,2,69011,69258,0.9964336249963903
polygon,936,1,69012,69258,0.9964480637615871
polygon,951,1,69013,69258,0.9964625025267839
polygon,967,1,69014,69258,0.9964769412919807
polygon,972,2,69016,69258,0.9965058188223743
polygon,987,1,69017,69258,0.9965202575875711
polygon,1000,1,69018,69258,0.9965346963527679
polygon,1004,1,69019,69258,0.9965491351179647
polygon,1005,1,69020,69258,0.9965635738831615
polygon,1013,1,69021,69258,0.9965780126483583
polygon,1020,1,69022,69258,0.9965924514135551
polygon,1023,1,69023,69258,0.9966068901787519
polygon,1032,1,69024,69258,0.9966213289439487
polygon,1034,1,69025,69258,0.9966357677091455
polygon,1038,1,69026,69258,0.9966502064743423
polygon,1046,1,69027,69258,0.9966646452395391
polygon,1048,1,69028,69258,0.9966790840047359
polygon,1050,1,69029,69258,0.9966935227699327
polygon,1060,1,69030,69258,0.9967079615351295
polygon,1070,1,69031,69258,0.9967224003003263
polygon,1072,1,69032,69258,0.9967368390655231
polygon,1074,1,69033,69258,0.9967512778307199
polygon,1075,1,69034,69258,0.9967657165959167
polygon,1081,1,69035,69258,0.9967801553611135
polygon,1101,1,69036,69258,0.9967945941263103
polygon,1122,1,69037,69258,0.9968090328915071
polygon,1144,1,69038,69258,0.9968234716567039
polygon,1156,1,69039,69258,0.9968379104219007
polygon,1183,1,69040,69258,0.9968523491870975
polygon,1198,1,69041,69258,0.9968667879522943
polygon,1202,1,69042,69258,0.9968812267174911
polygon,1211,1,69043,69258,0.9968956654826879
polygon,1216,1,69044,69258,0.9969101042478847
polygon,1229,1,69045,69258,0.9969245430130815
polygon,1242,1,69046,69258,0.9969389817782783
polygon,1246,1,69047,69258,0.9969534205434751
polygon,1255,2,69049,69258,0.9969822980738687
polygon,1260,1,69050,69258,0.9969967368390655
polygon,1296,1,69051,69258,0.9970111756042623
polygon,1303,1,69052,69258,0.9970256143694591
polygon,1314,1,69053,69258,0.9970400531346559
polygon,1326,1,69054,69258,0.9970544918998527
polygon,1327,1,69055,69258,0.9970689306650495
polygon,1330,1,69056,69258,0.9970833694302463
polygon,1338,1,69057,69258,0.9970978081954431
polygon,1361,1,69058,69258,0.9971122469606399
polygon,1366,1,69059,69258,0.9971266857258367
polygon,1389,1,69060,69258,0.9971411244910335
polygon,1400,1,69061,69258,0.9971555632562303
polygon,1412,1,69062,69258,0.9971700020214271
polygon,1413,1,69063,69258,0.9971844407866239
polygon,1431,1,69064,69258,0.9971988795518207
polygon,1482,1,69065,69258,0.9972133183170175
polygon,1485,1,69066,69258,0.9972277570822143
polygon,1500,1,69067,69258,0.9972421958474111
polygon,1502,1,69068,69258,0.9972566346126079
polygon,1522,1,69069,69258,0.9972710733778047
polygon,1526,1,69070,69258,0.9972855121430015
polygon,1530,1,69071,69258,0.9972999509081983
polygon,1535,1,69072,69258,0.9973143896733951
polygon,1543,1,69073,69258,0.9973288284385919
polygon,1546,1,69074,69258,0.9973432672037887
polygon,1549,1,69075,69258,0.9973577059689855
polygon,1561,1,69076,69258,0.9973721447341823
polygon,1566,1,69077,69258,0.9973865834993791
polygon,1571,1,69078,69258,0.9974010222645759
polygon,1580,1,69079,69258,0.9974154610297727
polygon,1588,1,69080,69258,0.9974298997949695
polygon,1600,1,69081,69258,0.9974443385601663
polygon,1606,1,69082,69258,0.9974587773253631
polygon,1619,1,69083,69258,0.9974732160905599
polygon,1622,1,69084,69258,0.9974876548557567
polygon,1634,1,69085,69258,0.9975020936209535
polygon,1642,1,69086,69258,0.9975165323861503
polygon,1650,1,69087,69258,0.9975309711513471
polygon,1653,1,69088,69258,0.997545409916544
polygon,1677,1,69089,69258,0.9975598486817407
polygon,1683,1,69090,69258,0.9975742874469375
polygon,1756,1,69091,69258,0.9975887262121343
polygon,1761,1,69092,69258,0.9976031649773311
polygon,1765,1,69093,69258,0.997617603742528
polygon,1766,1,69094,69258,0.9976320425077247
polygon,1797,1,69095,69258,0.9976464812729215
polygon,1806,1,69096,69258,0.9976609200381183
polygon,1836,1,69097,69258,0.9976753588033151
polygon,1850,1,69098,69258,0.997689797568512
polygon,1861,1,69099,69258,0.9977042363337087
polygon,1868,1,69100,69258,0.9977186750989055
polygon,1870,1,69101,69258,0.9977331138641024
polygon,1894,1,69102,69258,0.9977475526292992
polygon,1902,1,69103,69258,0.997761991394496
polygon,1904,1,69104,69258,0.9977764301596928
polygon,1908,1,69105,69258,0.9977908689248896
polygon,1921,1,69106,69258,0.9978053076900864
polygon,1968,1,69107,69258,0.9978197464552832
polygon,2001,1,69108,69258,0.99783418522048
polygon,2034,1,69109,69258,0.9978486239856768
polygon,2052,1,69110,69258,0.9978630627508736
polygon,2100,1,69111,69258,0.9978775015160704
polygon,2130,1,69112,69258,0.9978919402812672
polygon,2138,1,69113,69258,0.997906379046464
polygon,2163,1,69114,69258,0.9979208178116608
polygon,2168,1,69115,69258,0.9979352565768576
polygon,2196,1,69116,69258,0.9979496953420544
polygon,2213,1,69117,69258,0.9979641341072512
polygon,2218,1,69118,69258,0.997978572872448
polygon,2317,1,69119,69258,0.9979930116376448
polygon,2394,1,69120,69258,0.9980074504028416
polygon,2510,1,69121,69258,0.9980218891680384
polygon,2536,1,69122,69258,0.9980363279332352
polygon,2548,1,69123,69258,0.998050766698432
polygon,2571,1,69124,69258,0.9980652054636288
polygon,2678,1,69125,69258,0.9980796442288256
polygon,2738,1,69126,69258,0.9980940829940224
polygon,2763,1,69127,69258,0.9981085217592192
polygon,2775,1,69128,69258,0.998122960524416
polygon,2800,1,69129,69258,0.9981373992896128
polygon,2834,1,69130,69258,0.9981518380548096
polygon,2866,1,69131,69258,0.9981662768200064
polygon,2867,1,69132,69258,0.9981807155852032
polygon,2887,1,69133,69258,0.9981951543504
polygon,2970,1,69134,69258,0.9982095931155968
polygon,2971,1,69135,69258,0.9982240318807936
polygon,3167,1,69136,69258,0.9982384706459904
polygon,3170,1,69137,69258,0.9982529094111872
polygon,3188,1,69138,69258,0.998267348176384
polygon,3226,1,69139,69258,0.9982817869415808
polygon,3231,1,69140,69258,0.9982962257067776
polygon,3246,1,69141,69258,0.9983106644719744
polygon,3311,1,69142,69258,0.9983251032371712
polygon,3396,1,69143,69258,0.998339542002368
polygon,3600,1,69144,69258,0.9983539807675648
polygon,3602,1,69145,69258,0.9983684195327616
polygon,3606,1,69146,69258,0.9983828582979584
polygon,3660,1,69147,69258,0.9983972970631552
polygon,3684,1,69148,69258,0.998411735828352
polygon,3748,1,69149,69258,0.9984261745935488
polygon,3800,1,69150,69258,0.9984406133587456
polygon,3840,1,69151,69258,0.9984550521239424
polygon,3864,1,69152,69258,0.9984694908891392
polygon,4014,1,69153,69258,0.998483929654336
polygon,4081,1,69154,69258,0.9984983684195328
polygon,4091,1,69155,69258,0.9985128071847296
polygon,4104,1,69156,69258,0.9985272459499264
polygon,4140,1,69157,69258,0.9985416847151232
polygon,4306,1,69158,69258,0.99855612348032
polygon,4512,1,69159,69258,0.9985705622455168
polygon,4660,1,69160,69258,0.9985850010107136
polygon,4678,1,69161,69258,0.9985994397759104
polygon,4940,1,69162,69258,0.9986138785411072
polygon,5105,1,69163,69258,0.998628317306304
polygon,5400,1,69164,69258,0.9986427560715008
polygon,5580,1,69165,69258,0.9986571948366976
polygon,5655,1,69166,69258,0.9986716336018944
polygon,5668,1,69167,69258,0.9986860723670912
polygon,5725,1,69168,69258,0.998700511132288
polygon,5748,1,69169,69258,0.9987149498974848
polygon,6334,1,69170,69258,0.9987293886626816
polygon,6439,1,69171,69258,0.9987438274278784
polygon,6645,1,69172,69258,0.9987582661930752
polygon,6770,1,69173,69258,0.998772704958272
polygon,6882,1,69174,69258,0.9987871437234688
polygon,6906,1,69175,69258,0.9988015824886656
polygon,6951,1,69176,69258,0.9988160212538624
polygon,6989,1,69177,69258,0.9988304600190592
polygon,7161,1,69178,69258,0.998844898784256
polygon,7641,1,69179,69258,0.9988593375494528
polygon,8042,1,69180,69258,0.9988737763146496
polygon,8425,1,69181,69258,0.9988882150798464
polygon,8800,1,69182,69258,0.9989026538450432
polygon,8922,1,69183,69258,0.99891709261024
polygon,9510,1,69184,69258,0.9989315313754368
polygon,9664,1,69185,69258,0.9989459701406336
polygon,10000,1,69186,69258,0.9989604089058304
polygon,10076,1,69187,69258,0.9989748476710272
polygon,10143,1,69188,69258,0.998989286436224
polygon,10268,1,69189,69258,0.9990037252014208
polygon,10287,1,69190,69258,0.9990181639666176
polygon,11054,1,69191,69258,0.9990326027318144
polygon,11116,1,69192,69258,0.9990470414970112
polygon,11238,1,69193,69258,0.999061480262208
polygon,11291,1,69194,69258,0.9990759190274048
polygon,11930,1,69195,69258,0.9990903577926016
polygon,11997,1,69196,69258,0.9991047965577984
polygon,12160,1,69197,69258,0.9991192353229952
polygon,13513,1,69198,69258,0.999133674088192
polygon,13566,1,69199,69258,0.9991481128533888
polygon,13900,1,69200,69258,0.9991625516185856
polygon,13941,1,69201,69258,0.9991769903837824
polygon,16408,1,69202,69258,0.9991914291489792
polygon,16539,1,69203,69258,0.999205867914176
polygon,17404,1,69204,69258,0.9992203066793728
polygon,17598,1,69205,69258,0.9992347454445696
polygon,18307,1,69206,69258,0.9992491842097664
polygon,19182,1,69207,69258,0.9992636229749632
polygon,19499,1,69208,69258,0.99927806174016
polygon,20224,1,69209,69258,0.9992925005053568
polygon,20366,1,69210,69258,0.9993069392705536
polygon,20480,1,69211,69258,0.9993213780357504
polygon,21555,1,69212,69258,0.9993358168009472
polygon,21737,1,69213,69258,0.999350255566144
polygon,21892,1,69214,69258,0.9993646943313408
polygon,22604,1,69215,69258,0.9993791330965376
polygon,22900,1,69216,69258,0.9993935718617344
polygon,24000,1,69217,69258,0.9994080106269312
polygon,24770,1,69218,69258,0.999422449392128
polygon,26451,1,69219,69258,0.9994368881573248
polygon,27807,1,69220,69258,0.9994513269225216
polygon,29185,1,69221,69258,0.9994657656877184
polygon,30040,1,69222,69258,0.9994802044529152
polygon,30703,1,69223,69258,0.999494643218112
polygon,32537,1,69224,69258,0.9995090819833088
polygon,33142,1,69225,69258,0.9995235207485056
polygon,35379,1,69226,69258,0.9995379595137024
polygon,36189,1,69227,69258,0.9995523982788992
polygon,43900,1,69228,69258,0.999566837044096
polygon,44784,1,69229,69258,0.9995812758092928
polygon,47627,1,69230,69258,0.9995957145744896
polygon,48289,1,69231,69258,0.9996101533396864
polygon,48860,1,69232,69258,0.9996245921048832
polygon,50001,1,69233,69258,0.99963903087008
polygon,52800,1,69234,69258,0.9996534696352768
polygon,54608,1,69235,69258,0.9996679084004736
polygon,58350,1,69236,69258,0.9996823471656704
polygon,59190,1,69237,69258,0.9996967859308672
polygon,59636,1,69238,69258,0.999711224696064
polygon,60708,1,69239,69258,0.9997256634612608
polygon,65749,1,69240,69258,0.9997401022264576
polygon,81325,1,69241,69258,0.9997545409916544
polygon,97951,1,69242,69258,0.9997689797568512
polygon,108607,1,69243,69258,0.999783418522048
polygon,120517,1,69244,69258,0.9997978572872448
polygon,133185,1,69245,69258,0.9998122960524416
polygon,136063,1,69246,69258,0.9998267348176384
polygon,141213,1,69247,69258,0.9998411735828352
polygon,158716,1,69248,69258,0.999855612348032
polygon,160027,1,69249,69258,0.9998700511132288
polygon,226107,1,69250,69258,0.9998844898784256
polygon,311300,1,69251,69258,0.9998989286436224
polygon,336169,1,69252,69258,0.9999133674088192
polygon,372700,1,69253,69258,0.999927806174016
polygon,721838,1,69254,69258,0.9999422449392128
polygon,858214,1,69255,69258,0.9999566837044096
polygon,940281,1,69256,69258,0.9999711224696064
polygon,1580440,1,69257,69258,0.9999855612348032
polygon,2662562,1,69258,69258,1.0
